,用户ID (User ID),用户行为 (User behaviour),博主ID (Blogger ID),时间 (Time),当前博主观看数,当前博主点赞数,当前博主评论数,当前博主关注数,当前博主互动数
31717,U22405,2,B52,2024-07-11 16:37:48,219,172,36,6,433
31718,U22405,1,B52,2024-07-11 16:37:48,220,172,36,6,434
31842,U22405,2,B42,2024-07-11 16:38:27,221,158,42,5,426
31844,U22405,1,B42,2024-07-11 16:38:27,222,158,42,5,427
31878,U9,1,B76,2024-07-11 16:38:37,450,234,74,26,784
31880,U9,3,B76,2024-07-11 16:38:37,450,234,75,26,785
31986,U22405,1,B47,2024-07-11 16:39:06,395,314,45,16,770
31987,U22405,2,B47,2024-07-11 16:39:06,395,315,45,16,771
32249,U22405,1,B44,2024-07-11 16:40:34,357,251,50,18,676
32250,U22405,3,B44,2024-07-11 16:40:34,357,251,51,18,677
32391,U22405,2,B59,2024-07-11 16:41:07,356,231,101,15,703
32393,U22405,1,B59,2024-07-11 16:41:07,357,231,101,15,704
34524,U9,2,B72,2024-07-11 16:51:37,431,179,59,26,695
34526,U9,1,B72,2024-07-11 16:51:37,432,179,59,26,696
35876,U9,2,B7,2024-07-11 16:58:23,566,306,96,23,991
35877,U9,1,B7,2024-07-11 16:58:23,567,306,96,23,992
36975,U9,1,B24,2024-07-11 17:03:39,623,353,111,20,1107
40036,U9,4,B23,2024-07-11 17:16:33,778,457,109,41,1385
40038,U9,1,B23,2024-07-11 17:16:33,779,457,109,41,1386
40039,U9,2,B23,2024-07-11 17:16:33,779,458,109,41,1387
58232,U9,1,B24,2024-07-11 18:52:32,1003,598,177,40,1818
58234,U9,2,B24,2024-07-11 18:52:32,1003,599,177,40,1819
58450,U9,1,B7,2024-07-11 18:53:51,935,562,205,56,1758
59554,U9,1,B23,2024-07-11 19:00:39,1192,722,181,71,2166
61444,U9,2,B4,2024-07-11 19:10:33,1413,757,307,71,2548
61445,U9,3,B4,2024-07-11 19:10:33,1413,757,308,71,2549
61448,U9,1,B4,2024-07-11 19:10:33,1414,757,308,71,2550
89583,U9,1,B13,2024-07-11 22:02:14,2072,1235,342,109,3758
89585,U9,2,B13,2024-07-11 22:02:14,2072,1236,342,109,3759
90373,U9,1,B12,2024-07-11 22:05:38,1705,776,319,98,2898
90374,U9,2,B12,2024-07-11 22:05:38,1705,777,319,98,2899
92157,U9,1,B22,2024-07-11 22:13:38,152,75,33,16,276
96551,U9,3,B24,2024-07-11 22:38:06,1629,958,276,68,2931
96553,U9,1,B24,2024-07-11 22:38:06,1630,958,276,68,2932
103561,U9,1,B2,2024-07-11 23:20:32,1888,935,389,128,3340
103562,U9,4,B2,2024-07-11 23:20:32,1888,935,389,129,3341
105993,U9,1,B68,2024-07-11 23:39:57,929,305,155,48,1437
105994,U9,3,B68,2024-07-11 23:39:57,929,305,156,48,1438
111482,U9,3,B3,2024-07-12 00:17:56,1800,1134,321,122,3377
111483,U9,2,B3,2024-07-12 00:17:56,1800,1135,321,122,3378
111484,U9,1,B3,2024-07-12 00:17:56,1801,1135,321,122,3379
112796,U16,1,B2,2024-07-12 00:24:37,2066,1038,429,148,3681
115901,U16,2,B68,2024-07-12 00:42:03,1036,351,172,56,1615
115903,U16,1,B68,2024-07-12 00:42:03,1037,351,172,56,1616
122102,U16,3,B7,2024-07-12 01:13:28,2162,1359,457,148,4126
122103,U16,1,B7,2024-07-12 01:13:28,2163,1359,457,148,4127
122795,U16,2,B13,2024-07-12 01:16:31,2845,1699,484,159,5187
122796,U16,1,B13,2024-07-12 01:16:31,2846,1699,484,159,5188
123199,U16,1,B12,2024-07-12 01:18:08,2263,1067,412,129,3871
136914,U9,1,B7,2024-07-12 02:08:06,2425,1523,516,160,4624
144904,U9,1,B27,2024-07-12 02:39:58,367,237,88,32,724
144907,U9,3,B27,2024-07-12 02:39:58,367,237,89,32,725
144908,U9,4,B27,2024-07-12 02:39:58,367,237,89,33,726
144909,U9,2,B27,2024-07-12 02:39:58,367,238,89,33,727
152586,U9,2,B16,2024-07-12 03:12:38,1272,794,268,94,2428
152592,U9,1,B16,2024-07-12 03:12:38,1273,794,268,94,2429
218065,U9,1,B6,2024-07-12 15:45:36,976,504,157,65,1702
220530,U9,1,B23,2024-07-12 15:55:24,3786,2157,554,216,6713
221331,U9,2,B4,2024-07-12 15:58:49,4457,2301,864,241,7863
221335,U9,1,B4,2024-07-12 15:58:49,4458,2301,864,241,7864
229943,U9,1,B68,2024-07-12 16:31:03,1698,541,262,82,2583
229945,U9,3,B68,2024-07-12 16:31:03,1698,541,263,82,2584
229946,U9,2,B68,2024-07-12 16:31:03,1698,542,263,82,2585
230806,U9,1,B24,2024-07-12 16:34:34,3298,1923,536,131,5888
232397,U22405,1,B43,2024-07-12 16:40:44,1466,1052,360,66,2944
232398,U22405,3,B43,2024-07-12 16:40:44,1466,1052,361,66,2945
232658,U22405,1,B52,2024-07-12 16:41:59,1959,1390,491,84,3924
232659,U22405,3,B52,2024-07-12 16:41:59,1959,1390,492,84,3925
233010,U22405,1,B42,2024-07-12 16:43:18,2095,1416,578,49,4138
233011,U22405,3,B42,2024-07-12 16:43:18,2095,1416,579,49,4139
233153,U22405,1,B47,2024-07-12 16:43:50,3081,2438,530,75,6124
233154,U22405,2,B47,2024-07-12 16:43:50,3081,2439,530,75,6125
233272,U22405,1,B44,2024-07-12 16:44:23,3221,2203,697,167,6288
233452,U22405,1,B59,2024-07-12 16:45:04,3579,2370,1040,148,7137
233453,U22405,2,B59,2024-07-12 16:45:04,3579,2371,1040,148,7138
233859,U22405,1,B45,2024-07-12 16:46:41,3017,2068,771,136,5992
233860,U22405,3,B45,2024-07-12 16:46:41,3017,2068,772,136,5993
234923,U9,2,B2,2024-07-12 16:50:48,4254,2117,806,256,7433
234924,U9,1,B2,2024-07-12 16:50:48,4255,2117,806,256,7434
326310,U9,1,B2,2024-07-12 23:45:34,6008,3088,1150,350,10596
326312,U9,3,B2,2024-07-12 23:45:34,6008,3088,1151,350,10597
329424,U9,3,B7,2024-07-12 23:59:11,5885,3597,1124,332,10938
329425,U9,1,B7,2024-07-12 23:59:11,5886,3597,1124,332,10939
329468,U9,1,B6,2024-07-12 23:59:25,2348,1294,381,148,4171
329997,U9,1,B8,2024-07-13 00:01:45,2793,1924,448,190,5355
333452,U9,2,B68,2024-07-13 00:16:02,2365,728,366,121,3580
333453,U9,1,B68,2024-07-13 00:16:02,2366,728,366,121,3581
339560,U9,4,B21,2024-07-13 00:44:29,16323,9457,2913,588,29281
339561,U9,1,B21,2024-07-13 00:44:29,16324,9457,2913,588,29282
340022,U9,1,B24,2024-07-13 00:46:31,4933,2879,820,189,8821
340856,U9,1,B23,2024-07-13 00:50:18,5902,3402,878,334,10516
340858,U9,3,B23,2024-07-13 00:50:18,5902,3402,879,334,10517
349079,U9,4,B12,2024-07-13 01:25:15,5667,2735,1049,358,9809
349083,U9,1,B12,2024-07-13 01:25:15,5668,2735,1049,358,9810
349634,U9,3,B72,2024-07-13 01:27:34,4600,2258,637,278,7773
349636,U9,1,B72,2024-07-13 01:27:34,4601,2258,637,278,7774
350198,U9,1,B13,2024-07-13 01:29:48,7521,4301,1448,447,13717
350202,U9,2,B13,2024-07-13 01:29:48,7521,4302,1448,447,13718
359077,U9,2,B3,2024-07-13 02:02:29,5986,3336,1021,390,10733
359081,U9,3,B3,2024-07-13 02:02:29,5986,3336,1022,390,10734
359083,U9,1,B3,2024-07-13 02:02:29,5987,3336,1022,390,10735
363115,U22405,2,B59,2024-07-13 02:15:29,5564,3705,1643,204,11116
363116,U22405,1,B59,2024-07-13 02:15:29,5565,3705,1643,204,11117
363282,U22405,2,B44,2024-07-13 02:16:04,4907,3181,1198,276,9562
363283,U22405,1,B44,2024-07-13 02:16:04,4908,3181,1198,276,9563
363474,U22405,1,B47,2024-07-13 02:16:41,4713,3676,905,103,9397
363475,U22405,2,B47,2024-07-13 02:16:41,4713,3677,905,103,9398
363782,U22405,1,B42,2024-07-13 02:17:46,3472,2342,960,98,6872
363784,U22405,2,B42,2024-07-13 02:17:46,3472,2343,960,98,6873
363984,U22405,1,B52,2024-07-13 02:18:24,3183,2249,809,132,6373
363986,U22405,2,B52,2024-07-13 02:18:24,3183,2250,809,132,6374
364447,U22405,1,B46,2024-07-13 02:20:03,1508,1045,415,39,3007
364448,U22405,2,B46,2024-07-13 02:20:03,1508,1046,415,39,3008
404894,U9,3,B3,2024-07-13 06:10:05,6713,3766,1145,444,12068
404895,U9,1,B3,2024-07-13 06:10:05,6714,3766,1145,444,12069
405915,U9,1,B27,2024-07-13 06:19:04,2557,1440,538,179,4714
405916,U9,2,B27,2024-07-13 06:19:04,2557,1441,538,179,4715
406935,U9,2,B72,2024-07-13 06:30:42,5227,2578,716,308,8829
406936,U9,1,B72,2024-07-13 06:30:42,5228,2578,716,308,8830
407891,U9,1,B25,2024-07-13 06:43:55,3850,2887,572,209,7518
407892,U9,2,B25,2024-07-13 06:43:55,3850,2888,572,209,7519
407893,U9,3,B25,2024-07-13 06:43:55,3850,2888,573,209,7520
412554,U9,1,B25,2024-07-13 08:22:57,3912,2919,581,209,7621
412555,U9,2,B25,2024-07-13 08:22:57,3912,2920,581,209,7622
413027,U9,2,B3,2024-07-13 08:40:07,6912,3848,1176,454,12390
413028,U9,1,B3,2024-07-13 08:40:07,6913,3848,1176,454,12391
413737,U9,1,B12,2024-07-13 09:10:22,6672,3266,1226,419,11583
413738,U9,3,B12,2024-07-13 09:10:22,6672,3266,1227,419,11584
413793,U9,1,B16,2024-07-13 09:12:54,3372,2111,656,233,6372
416259,U48420,1,B5,2024-07-13 11:34:22,19903,12773,3044,663,36383
416260,U48420,2,B5,2024-07-13 11:34:22,19903,12774,3044,663,36384
416268,U48420,1,B21,2024-07-13 11:35:12,20001,11446,3553,695,35695
416561,U48420,1,B26,2024-07-13 11:58:02,3470,1580,658,259,5967
416562,U48420,3,B26,2024-07-13 11:58:02,3470,1580,659,259,5968
417430,U48420,4,B3,2024-07-13 12:57:44,7050,3908,1198,459,12615
417431,U48420,3,B3,2024-07-13 12:57:44,7050,3908,1199,459,12616
417432,U48420,1,B3,2024-07-13 12:57:44,7051,3908,1199,459,12617
418212,U48420,3,B2,2024-07-13 13:28:38,7612,3901,1439,434,13386
418213,U48420,1,B2,2024-07-13 13:28:38,7613,3901,1439,434,13387
418214,U48420,2,B2,2024-07-13 13:28:38,7613,3902,1439,434,13388
418215,U48420,4,B2,2024-07-13 13:28:38,7613,3902,1439,435,13389
418446,U48420,1,B15,2024-07-13 13:33:18,14924,8107,2901,557,26489
418535,U48420,1,B25,2024-07-13 13:35:06,3998,2961,592,214,7765
419626,U48420,2,B6,2024-07-13 13:48:44,3183,1734,514,208,5639
419629,U48420,1,B6,2024-07-13 13:48:44,3184,1734,514,208,5640
420435,U48420,2,B20,2024-07-13 13:58:23,7064,4688,1545,313,13610
420436,U48420,1,B20,2024-07-13 13:58:23,7065,4688,1545,313,13611
443151,U48420,1,B7,2024-07-13 15:40:27,7796,4707,1404,413,14320
443153,U48420,3,B7,2024-07-13 15:40:27,7796,4707,1405,413,14321
443967,U48420,3,B27,2024-07-13 15:42:49,2842,1562,579,191,5174
443968,U48420,1,B27,2024-07-13 15:42:49,2843,1562,579,191,5175
451835,U48420,2,B21,2024-07-13 16:01:54,21652,12285,3824,762,38523
451844,U48420,3,B21,2024-07-13 16:01:54,21652,12285,3825,762,38524
451845,U48420,1,B21,2024-07-13 16:01:54,21653,12285,3825,762,38525
452148,U48420,1,B60,2024-07-13 16:02:33,9074,3784,1984,363,15205
452452,U48420,2,B5,2024-07-13 16:03:10,21598,13749,3358,703,39408
452453,U48420,1,B5,2024-07-13 16:03:10,21599,13749,3358,703,39409
454538,U48420,1,B20,2024-07-13 16:07:26,7460,4960,1617,320,14357
454539,U48420,2,B20,2024-07-13 16:07:26,7460,4961,1617,320,14358
458774,U48420,2,B4,2024-07-13 16:17:14,8851,4662,1763,503,15779
458784,U48420,1,B4,2024-07-13 16:17:14,8852,4662,1763,503,15780
460192,U48420,3,B23,2024-07-13 16:20:48,7722,4381,1196,427,13726
460194,U48420,1,B23,2024-07-13 16:20:48,7723,4381,1196,427,13727
461034,U48420,3,B24,2024-07-13 16:22:44,6514,3731,1149,250,11644
461035,U48420,1,B24,2024-07-13 16:22:44,6515,3731,1149,250,11645
461513,U48420,2,B25,2024-07-13 16:24:14,4537,3364,703,236,8840
461514,U48420,1,B25,2024-07-13 16:24:14,4538,3364,703,236,8841
463674,U48420,2,B17,2024-07-13 16:30:16,5123,3674,1267,201,10265
463676,U48420,1,B17,2024-07-13 16:30:16,5124,3674,1267,201,10266
465674,U9,1,B27,2024-07-13 16:36:18,3030,1687,615,200,5532
465676,U9,2,B27,2024-07-13 16:36:18,3030,1688,615,200,5533
465827,U22405,1,B43,2024-07-13 16:36:42,3183,2304,776,121,6384
465830,U22405,3,B43,2024-07-13 16:36:42,3183,2304,777,121,6385
466146,U22405,2,B52,2024-07-13 16:37:36,4222,3034,1024,148,8428
466148,U22405,1,B52,2024-07-13 16:37:36,4223,3034,1024,148,8429
466383,U22405,1,B42,2024-07-13 16:38:27,4465,2969,1261,125,8820
466386,U22405,2,B42,2024-07-13 16:38:27,4465,2970,1261,125,8821
466551,U22405,1,B47,2024-07-13 16:39:01,6052,4688,1208,134,12082
466552,U22405,2,B47,2024-07-13 16:39:01,6052,4689,1208,134,12083
466703,U22405,1,B44,2024-07-13 16:39:35,6379,4087,1579,354,12399
466851,U22405,2,B59,2024-07-13 16:40:10,7329,4892,2169,234,14624
466852,U22405,1,B59,2024-07-13 16:40:10,7330,4892,2169,234,14625
467458,U22405,1,B45,2024-07-13 16:41:57,6344,4317,1700,274,12635
467459,U22405,3,B45,2024-07-13 16:41:57,6344,4317,1701,274,12636
471153,U9,1,B23,2024-07-13 16:53:28,7904,4496,1241,442,14083
471161,U9,2,B23,2024-07-13 16:53:28,7904,4497,1241,442,14084
471897,U9,1,B4,2024-07-13 16:55:36,9059,4791,1828,527,16205
471901,U9,2,B4,2024-07-13 16:55:36,9059,4792,1828,527,16206
472756,U9,1,B68,2024-07-13 16:58:21,3166,993,494,160,4813
478740,U48420,1,B76,2024-07-13 17:16:53,5360,2964,828,362,9514
478741,U48420,3,B76,2024-07-13 17:16:53,5360,2964,829,362,9515
478742,U48420,2,B76,2024-07-13 17:16:53,5360,2965,829,362,9516
481477,U9,3,B24,2024-07-13 17:26:40,6830,3906,1251,266,12253
481478,U9,1,B24,2024-07-13 17:26:40,6831,3906,1251,266,12254
481482,U9,2,B24,2024-07-13 17:26:40,6831,3907,1251,266,12255
481559,U48420,1,B12,2024-07-13 17:27:01,7804,3739,1431,452,13426
483448,U9,1,B2,2024-07-13 17:34:26,8711,4500,1644,475,15330
485197,U9,1,B13,2024-07-13 17:41:15,10224,5802,1932,576,18534
492627,U48420,1,B13,2024-07-13 18:10:05,10380,5906,1962,581,18829
493112,U48420,1,B12,2024-07-13 18:11:36,7988,3846,1469,463,13766
493268,U48420,1,B72,2024-07-13 18:12:11,6370,3050,907,365,10692
495523,U48420,2,B8,2024-07-13 18:21:07,3991,2761,640,276,7668
495525,U48420,1,B8,2024-07-13 18:21:07,3992,2761,640,276,7669
499586,U48420,1,B2,2024-07-13 18:38:12,9010,4674,1705,489,15878
499587,U48420,2,B2,2024-07-13 18:38:12,9010,4675,1705,489,15879
499588,U48420,3,B2,2024-07-13 18:38:12,9010,4675,1706,489,15880
500042,U48420,1,B21,2024-07-13 18:40:06,23751,13411,4371,858,42391
501918,U48420,1,B6,2024-07-13 18:48:22,4072,2217,632,255,7176
505136,U48420,2,B26,2024-07-13 19:02:05,4022,1786,744,289,6841
505139,U48420,1,B26,2024-07-13 19:02:05,4023,1786,744,289,6842
510657,U9,1,B12,2024-07-13 19:23:42,8242,3969,1519,487,14217
510659,U9,3,B12,2024-07-13 19:23:42,8242,3969,1520,487,14218
510661,U9,2,B12,2024-07-13 19:23:42,8242,3970,1520,487,14219
529405,U48420,1,B7,2024-07-13 20:50:24,9319,5628,1765,522,17234
530286,U48420,2,B15,2024-07-13 20:55:39,18601,9987,3802,700,33090
530290,U48420,1,B15,2024-07-13 20:55:39,18602,9987,3802,700,33091
531196,U48420,1,B17,2024-07-13 21:00:35,5869,4197,1469,244,11779
531198,U48420,2,B17,2024-07-13 21:00:35,5869,4198,1469,244,11780
535471,U9,1,B3,2024-07-13 21:21:23,8447,4605,1481,548,15081
536124,U48420,3,B10,2024-07-13 21:24:26,4847,3696,968,162,9673
536126,U48420,2,B10,2024-07-13 21:24:26,4847,3697,968,162,9674
536127,U48420,4,B10,2024-07-13 21:24:26,4847,3697,968,163,9675
536129,U48420,1,B10,2024-07-13 21:24:26,4848,3697,968,163,9676
537112,U9,2,B7,2024-07-13 21:29:03,9469,5714,1793,528,17504
537113,U9,1,B7,2024-07-13 21:29:03,9470,5714,1793,528,17505
537995,U48420,2,B72,2024-07-13 21:33:30,6927,3352,984,414,11677
537997,U48420,1,B72,2024-07-13 21:33:30,6928,3352,984,414,11678
538282,U48420,2,B12,2024-07-13 21:35:06,8617,4159,1593,509,14878
538283,U48420,1,B12,2024-07-13 21:35:06,8618,4159,1593,509,14879
538772,U9,1,B12,2024-07-13 21:37:29,8627,4163,1595,509,14894
538773,U9,2,B12,2024-07-13 21:37:29,8627,4164,1595,509,14895
541513,U9,1,B23,2024-07-13 21:51:32,9113,5257,1455,538,16363
541514,U9,2,B23,2024-07-13 21:51:32,9113,5258,1455,538,16364
541558,U9,1,B13,2024-07-13 21:51:46,11420,6507,2195,657,20779
541904,U9,1,B4,2024-07-13 21:53:16,10397,5536,2137,618,18688
544018,U48420,1,B6,2024-07-13 22:03:08,4627,2523,727,295,8172
544019,U48420,3,B6,2024-07-13 22:03:08,4627,2523,728,295,8173
544083,U48420,1,B3,2024-07-13 22:03:24,8582,4677,1498,559,15316
544631,U48420,2,B2,2024-07-13 22:05:28,9904,5182,1885,532,17503
544633,U48420,1,B2,2024-07-13 22:05:28,9905,5182,1885,532,17504
544768,U48420,1,B5,2024-07-13 22:06:01,25653,16356,4172,948,47129
544770,U48420,2,B5,2024-07-13 22:06:01,25653,16357,4172,948,47130
545656,U48420,3,B4,2024-07-13 22:09:59,10483,5578,2157,625,18843
545657,U48420,1,B4,2024-07-13 22:09:59,10484,5578,2157,625,18844
549112,U48420,1,B23,2024-07-13 22:27:06,9257,5342,1478,545,16622
549113,U48420,4,B23,2024-07-13 22:27:06,9257,5342,1478,546,16623
549114,U48420,3,B23,2024-07-13 22:27:06,9257,5342,1479,546,16624
549115,U48420,2,B23,2024-07-13 22:27:06,9257,5343,1479,546,16625
557840,U48420,1,B26,2024-07-13 23:08:19,4442,1955,809,313,7519
557844,U48420,4,B26,2024-07-13 23:08:19,4442,1955,809,314,7520
558154,U48420,1,B19,2024-07-13 23:09:21,9153,5527,1765,408,16853
558875,U9,3,B25,2024-07-13 23:12:10,5784,4359,894,308,11345
558880,U9,1,B25,2024-07-13 23:12:10,5785,4359,894,308,11346
564913,U9,3,B8,2024-07-13 23:38:23,4530,3138,744,312,8724
564914,U9,1,B8,2024-07-13 23:38:23,4531,3138,744,312,8725
611628,U48420,1,B2,2024-07-14 03:26:48,11175,5871,2192,611,19849
611629,U48420,3,B2,2024-07-14 03:26:48,11175,5871,2193,611,19850
611817,U48420,1,B5,2024-07-14 03:27:52,28915,18476,4938,1164,53493
611818,U48420,3,B5,2024-07-14 03:27:52,28915,18476,4939,1164,53494
612876,U48420,1,B20,2024-07-14 03:33:56,10025,6531,2459,453,19468
612878,U48420,3,B20,2024-07-14 03:33:56,10025,6531,2460,453,19469
617709,U48420,1,B7,2024-07-14 04:04:15,10922,6604,2144,607,20277
617710,U48420,3,B7,2024-07-14 04:04:15,10922,6604,2145,607,20278
618218,U48420,1,B13,2024-07-14 04:07:39,13046,7519,2527,752,23844
618219,U48420,2,B13,2024-07-14 04:07:39,13046,7520,2527,752,23845
618443,U48420,1,B12,2024-07-14 04:09:06,9797,4768,1810,579,16954
618904,U48420,2,B45,2024-07-14 04:12:01,8379,5701,2261,370,16711
618905,U48420,1,B45,2024-07-14 04:12:01,8380,5701,2261,370,16712
619123,U48420,3,B59,2024-07-14 04:13:27,9773,6453,2958,331,19515
619126,U48420,1,B59,2024-07-14 04:13:27,9774,6453,2958,331,19516
619236,U48420,1,B44,2024-07-14 04:14:10,8422,5344,2158,491,16415
619239,U48420,2,B44,2024-07-14 04:14:10,8422,5345,2158,491,16416
619355,U48420,2,B47,2024-07-14 04:14:51,8038,6176,1657,173,16044
619356,U48420,1,B47,2024-07-14 04:14:51,8039,6176,1657,173,16045
619600,U48420,3,B42,2024-07-14 04:16:12,5963,3988,1658,171,11780
619601,U48420,1,B42,2024-07-14 04:16:12,5964,3988,1658,171,11781
620013,U48420,1,B43,2024-07-14 04:18:38,4203,3038,1024,159,8424
620016,U48420,3,B43,2024-07-14 04:18:38,4203,3038,1025,159,8425
620625,U48420,1,B35,2024-07-14 04:22:27,3308,2422,785,133,6648
620626,U48420,2,B35,2024-07-14 04:22:27,3308,2423,785,133,6649
628019,U48420,2,B10,2024-07-14 05:07:40,5764,4361,1183,195,11503
628020,U48420,1,B10,2024-07-14 05:07:40,5765,4361,1183,195,11504
629654,U48420,2,B15,2024-07-14 05:17:38,22202,11901,4689,909,39701
629655,U48420,1,B15,2024-07-14 05:17:38,22203,11901,4689,909,39702
629863,U48420,2,B21,2024-07-14 05:18:57,29998,16834,5714,1160,53706
629865,U48420,1,B21,2024-07-14 05:18:57,29999,16834,5714,1160,53707
631011,U48420,2,B8,2024-07-14 05:25:54,5098,3518,855,343,9814
631012,U48420,1,B8,2024-07-14 05:25:54,5099,3518,855,343,9815
631371,U48420,3,B3,2024-07-14 05:28:41,9722,5373,1796,663,17554
631372,U48420,1,B3,2024-07-14 05:28:41,9723,5373,1796,663,17555
631467,U48420,1,B6,2024-07-14 05:29:14,5400,2967,848,331,9546
653353,U48420,1,B5,2024-07-14 14:17:40,31139,19834,5202,1246,57421
653355,U48420,2,B5,2024-07-14 14:17:40,31139,19835,5202,1246,57422
653554,U48420,2,B60,2024-07-14 14:18:54,12311,5262,2779,571,20923
653557,U48420,1,B60,2024-07-14 14:18:54,12312,5263,2779,571,20925
653601,U48420,1,B21,2024-07-14 14:19:13,31246,17302,5815,1186,55549
653602,U48420,2,B21,2024-07-14 14:19:13,31246,17303,5815,1186,55550
653718,U48420,1,B15,2024-07-14 14:20:02,23078,12294,4814,943,41129
654759,U48420,1,B34,2024-07-14 14:28:41,4785,2367,971,383,8506
654760,U48420,2,B34,2024-07-14 14:28:41,4785,2368,971,383,8507
654985,U48420,1,B4,2024-07-14 14:30:39,12309,6489,2559,724,22081
655484,U48420,1,B2,2024-07-14 14:34:20,11920,6182,2330,650,21082
655826,U48420,1,B6,2024-07-14 14:36:27,5566,3032,881,345,9824
656978,U48420,1,B26,2024-07-14 14:42:54,5292,2354,990,378,9014
657271,U48420,1,B19,2024-07-14 14:44:26,11062,6702,2095,481,20340
659058,U48420,2,B76,2024-07-14 14:52:29,7266,4053,1144,503,12966
659060,U48420,1,B76,2024-07-14 14:52:29,7267,4053,1144,503,12967
660369,U48420,1,B23,2024-07-14 14:58:16,10935,6288,1719,627,19569
660370,U48420,2,B23,2024-07-14 14:58:16,10935,6289,1719,627,19570
660771,U48420,3,B24,2024-07-14 15:00:06,9086,5264,1642,393,16385
660772,U48420,1,B24,2024-07-14 15:00:06,9087,5264,1642,393,16386
661114,U48420,1,B25,2024-07-14 15:01:30,6769,5067,1036,363,13235
661117,U48420,2,B25,2024-07-14 15:01:30,6769,5068,1036,363,13236
666184,U48420,3,B8,2024-07-14 15:21:02,5268,3594,873,349,10084
666186,U48420,1,B8,2024-07-14 15:21:02,5269,3594,873,349,10085
695873,U22405,1,B43,2024-07-14 16:48:18,4799,3463,1161,178,9601
695876,U22405,2,B43,2024-07-14 16:48:18,4799,3464,1161,178,9602
696024,U22405,1,B52,2024-07-14 16:48:52,6380,4573,1566,195,12714
696429,U22405,3,B42,2024-07-14 16:50:13,6719,4469,1864,187,13239
696430,U22405,1,B42,2024-07-14 16:50:13,6720,4469,1864,187,13240
696626,U22405,2,B47,2024-07-14 16:50:44,9065,6942,1900,191,18098
696629,U22405,1,B47,2024-07-14 16:50:44,9066,6942,1900,191,18099
696778,U22405,2,B44,2024-07-14 16:51:20,9549,5997,2480,558,18584
696782,U22405,1,B44,2024-07-14 16:51:20,9550,5997,2480,558,18585
696943,U22405,2,B59,2024-07-14 16:51:54,11139,7357,3365,361,22222
696951,U22405,1,B59,2024-07-14 16:51:54,11140,7357,3365,361,22223
697470,U22405,1,B45,2024-07-14 16:53:35,9515,6499,2485,403,18902
697471,U22405,3,B45,2024-07-14 16:53:35,9515,6499,2486,403,18903
699076,U48420,2,B19,2024-07-14 16:59:09,11676,7121,2190,496,21483
699081,U48420,1,B19,2024-07-14 16:59:09,11677,7121,2190,496,21484
699490,U48420,2,B18,2024-07-14 17:00:44,13350,7733,2023,488,23594
699497,U48420,1,B18,2024-07-14 17:00:44,13352,7734,2023,488,23597
701056,U48420,1,B5,2024-07-14 17:05:02,33360,21181,5749,1324,61614
701060,U48420,2,B5,2024-07-14 17:05:02,33360,21182,5749,1324,61615
702555,U48420,3,B4,2024-07-14 17:09:41,13025,6856,2758,780,23419
702557,U48420,1,B4,2024-07-14 17:09:41,13026,6856,2758,780,23420
712772,U9,1,B8,2024-07-14 17:46:29,5550,3808,932,368,10658
713380,U9,1,B7,2024-07-14 17:48:48,12508,7454,2446,683,23091
717073,U48420,2,B35,2024-07-14 18:04:03,4005,2961,926,159,8051
717074,U48420,1,B35,2024-07-14 18:04:03,4006,2961,926,159,8052
717076,U48420,4,B35,2024-07-14 18:04:03,4006,2961,926,160,8053
717079,U48420,3,B35,2024-07-14 18:04:03,4006,2961,927,160,8054
718741,U48420,2,B17,2024-07-14 18:10:59,7802,5495,2038,342,15677
718745,U48420,1,B17,2024-07-14 18:10:59,7803,5495,2038,342,15678
720071,U9,4,B6,2024-07-14 18:16:53,6233,3420,992,382,11027
720075,U9,1,B6,2024-07-14 18:16:53,6234,3420,992,382,11028
720291,U48420,1,B15,2024-07-14 18:17:36,25352,13383,5373,1012,45120
720295,U48420,2,B15,2024-07-14 18:17:36,25352,13384,5373,1012,45121
720410,U48420,1,B21,2024-07-14 18:18:11,34355,18955,6532,1312,61154
720848,U48420,1,B5,2024-07-14 18:19:59,34155,21718,5910,1349,63132
720849,U48420,2,B5,2024-07-14 18:19:59,34155,21719,5910,1349,63133
720978,U9,1,B2,2024-07-14 18:20:41,12980,6767,2536,689,22972
720979,U9,2,B2,2024-07-14 18:20:41,12980,6768,2536,689,22973
730716,U48420,3,B34,2024-07-14 19:03:50,5233,2575,1066,421,9295
730718,U48420,1,B34,2024-07-14 19:03:50,5234,2575,1066,421,9296
731003,U48420,1,B24,2024-07-14 19:04:59,10086,5842,1902,467,18297
732607,U48420,1,B60,2024-07-14 19:11:10,13644,5813,3175,643,23275
733205,U48420,1,B2,2024-07-14 19:13:25,13224,6898,2586,707,23415
733562,U48420,1,B3,2024-07-14 19:15:02,11219,6141,2097,767,20224
733563,U48420,2,B3,2024-07-14 19:15:02,11219,6142,2097,767,20225
733770,U48420,1,B6,2024-07-14 19:16:05,6385,3508,1018,390,11301
750425,U9,1,B4,2024-07-14 20:24:18,13941,7380,2995,857,25173
751383,U9,1,B2,2024-07-14 20:28:39,13575,7103,2669,726,24073
751734,U9,1,B13,2024-07-14 20:30:30,15692,9065,2987,886,28630
752236,U9,1,B12,2024-07-14 20:33:13,11719,5696,2174,688,20277
752239,U9,2,B12,2024-07-14 20:33:13,11719,5697,2174,688,20278
753680,U9,2,B7,2024-07-14 20:41:34,13297,7941,2601,731,24570
753684,U9,1,B7,2024-07-14 20:41:34,13299,7942,2602,731,24574
753967,U9,2,B8,2024-07-14 20:43:26,5951,4104,1002,392,11449
753970,U9,1,B8,2024-07-14 20:43:26,5952,4104,1002,392,11450
766014,U9,1,B72,2024-07-14 21:44:59,10017,4870,1413,588,16888
766015,U9,2,B72,2024-07-14 21:44:59,10017,4871,1413,588,16889
766604,U9,2,B16,2024-07-14 21:48:02,6061,3796,1204,412,11473
766606,U9,1,B16,2024-07-14 21:48:02,6062,3796,1204,412,11474
769262,U9,1,B23,2024-07-14 22:01:34,12730,7346,2082,737,22895
769263,U9,3,B23,2024-07-14 22:01:34,12730,7346,2083,737,22896
769264,U9,2,B23,2024-07-14 22:01:34,12730,7347,2083,737,22897
771600,U48420,3,B6,2024-07-14 22:11:22,6928,3780,1083,416,12207
771601,U48420,1,B6,2024-07-14 22:11:22,6929,3780,1083,416,12208
771654,U48420,1,B3,2024-07-14 22:11:39,11881,6459,2203,808,21351
772068,U48420,1,B2,2024-07-14 22:13:20,14037,7351,2750,752,24890
772154,U48420,1,B5,2024-07-14 22:13:47,36516,23271,6255,1433,67475
773046,U48420,1,B4,2024-07-14 22:18:03,14365,7597,3069,875,25906
773048,U48420,3,B4,2024-07-14 22:18:03,14365,7597,3070,875,25907
773217,U48420,1,B76,2024-07-14 22:18:46,8323,4664,1316,580,14883
777334,U9,1,B24,2024-07-14 22:38:13,10804,6249,2022,500,19575
777335,U9,2,B24,2024-07-14 22:38:13,10804,6250,2022,500,19576
777336,U9,3,B24,2024-07-14 22:38:13,10804,6250,2023,500,19577
777337,U9,4,B24,2024-07-14 22:38:13,10804,6250,2023,501,19578
778352,U9,2,B21,2024-07-14 22:43:09,36948,20352,7009,1403,65712
778353,U9,1,B21,2024-07-14 22:43:09,36949,20352,7009,1403,65713
784346,U48420,2,B7,2024-07-14 23:09:24,13900,8304,2699,759,25662
784347,U48420,1,B7,2024-07-14 23:09:24,13901,8304,2699,759,25663
784349,U48420,3,B7,2024-07-14 23:09:24,13901,8304,2700,759,25664
784400,U9,2,B27,2024-07-14 23:09:36,5912,3302,1153,375,10742
784401,U9,3,B27,2024-07-14 23:09:36,5912,3302,1154,375,10743
784402,U9,1,B27,2024-07-14 23:09:36,5913,3302,1154,375,10744
784927,U48420,2,B13,2024-07-14 23:11:44,16408,9446,3101,931,29886
784928,U48420,1,B13,2024-07-14 23:11:44,16409,9446,3101,931,29887
786867,U48420,1,B63,2024-07-14 23:19:11,2214,1504,556,152,4426
786869,U48420,2,B63,2024-07-14 23:19:11,2214,1505,556,152,4427
794752,U9,1,B4,2024-07-14 23:53:15,14780,7817,3160,893,26650
799050,U9,1,B7,2024-07-15 00:11:21,14189,8481,2747,778,26195
799052,U9,2,B7,2024-07-15 00:11:21,14189,8482,2747,778,26196
799709,U9,1,B13,2024-07-15 00:13:59,16721,9630,3152,952,30455
799710,U9,2,B13,2024-07-15 00:13:59,16721,9631,3152,952,30456
804643,U9,1,B12,2024-07-15 00:36:28,12552,6111,2306,752,21721
805931,U9,1,B6,2024-07-15 00:42:33,7321,4016,1161,461,12959
826943,U22405,2,B59,2024-07-15 02:00:31,13250,8816,3968,403,26437
826951,U22405,1,B59,2024-07-15 02:00:31,13251,8816,3968,403,26438
827092,U22405,1,B44,2024-07-15 02:00:51,11378,7046,3004,662,22090
827340,U22405,2,B47,2024-07-15 02:01:26,10862,8267,2354,233,21716
827341,U22405,1,B47,2024-07-15 02:01:26,10863,8267,2354,233,21717
827743,U22405,2,B42,2024-07-15 02:02:32,8215,5386,2306,230,16137
827749,U22405,1,B42,2024-07-15 02:02:32,8216,5386,2306,230,16138
827993,U22405,1,B52,2024-07-15 02:03:18,7724,5526,1921,229,15400
827994,U22405,2,B52,2024-07-15 02:03:18,7724,5527,1921,229,15401
828430,U22405,1,B43,2024-07-15 02:04:23,5761,4127,1402,204,11494
828431,U22405,3,B43,2024-07-15 02:04:23,5761,4127,1403,204,11495
829036,U22405,1,B46,2024-07-15 02:05:53,3547,2480,974,104,7105
829038,U22405,2,B46,2024-07-15 02:05:53,3547,2481,974,104,7106
831671,U48420,2,B13,2024-07-15 02:12:40,17398,10024,3298,1019,31739
831674,U48420,1,B13,2024-07-15 02:12:40,17399,10024,3298,1019,31740
832407,U48420,2,B12,2024-07-15 02:15:09,12929,6329,2376,772,22406
832410,U48420,1,B12,2024-07-15 02:15:09,12930,6329,2376,772,22407
834280,U48420,3,B45,2024-07-15 02:20:39,11440,7817,3043,492,22792
834282,U48420,1,B45,2024-07-15 02:20:39,11442,7817,3043,492,22794
837765,U48420,1,B15,2024-07-15 02:31:56,29275,15333,6342,1209,52159
837766,U48420,2,B15,2024-07-15 02:31:56,29275,15334,6342,1209,52160
838172,U48420,2,B21,2024-07-15 02:33:37,39728,21860,7735,1517,70840
838173,U48420,1,B21,2024-07-15 02:33:37,39729,21860,7735,1517,70841
843984,U9,1,B25,2024-07-15 02:57:58,9153,6889,1406,512,17960
844875,U9,2,B23,2024-07-15 03:02:04,13990,8096,2307,826,25219
844876,U9,1,B23,2024-07-15 03:02:04,13991,8096,2307,826,25220
852436,U9,1,B6,2024-07-15 03:31:17,7873,4318,1245,484,13920
852440,U9,3,B6,2024-07-15 03:31:17,7873,4318,1246,484,13921
853559,U48420,2,B5,2024-07-15 03:36:18,40225,25639,7141,1676,74681
853560,U48420,1,B5,2024-07-15 03:36:18,40226,25639,7141,1676,74682
854318,U48420,2,B20,2024-07-15 03:40:45,14025,8996,3465,755,27241
854319,U48420,1,B20,2024-07-15 03:40:45,14026,8996,3465,755,27242
859379,U48420,3,B4,2024-07-15 04:12:17,15858,8406,3421,971,28656
859382,U48420,1,B4,2024-07-15 04:12:17,15859,8406,3421,971,28657
859383,U48420,2,B4,2024-07-15 04:12:17,15859,8407,3421,971,28658
860219,U48420,1,B2,2024-07-15 04:16:40,15650,8219,3125,848,27842
861080,U48420,3,B6,2024-07-15 04:21:15,7925,4346,1260,485,14016
861081,U48420,1,B6,2024-07-15 04:21:15,7926,4346,1260,485,14017
861854,U9,3,B13,2024-07-15 04:25:04,17971,10353,3448,1068,32840
861855,U9,2,B13,2024-07-15 04:25:04,17971,10354,3448,1068,32841
861856,U9,1,B13,2024-07-15 04:25:04,17972,10354,3448,1068,32842
864638,U48420,3,B26,2024-07-15 04:40:33,6927,3009,1226,472,11634
864639,U48420,1,B26,2024-07-15 04:40:33,6928,3009,1226,472,11635
865280,U48420,1,B19,2024-07-15 04:44:09,14384,8894,2767,624,26669
865281,U48420,3,B19,2024-07-15 04:44:09,14384,8894,2768,624,26670
866196,U48420,2,B76,2024-07-15 04:50:02,9155,5203,1443,639,16440
866198,U48420,1,B76,2024-07-15 04:50:02,9156,5203,1443,639,16441
874055,U48420,3,B34,2024-07-15 05:39:55,6205,3097,1279,488,11069
874056,U48420,1,B34,2024-07-15 05:39:55,6206,3097,1279,488,11070
874057,U48420,2,B34,2024-07-15 05:39:55,6206,3098,1279,488,11071
874283,U48420,1,B24,2024-07-15 05:41:47,11979,6918,2249,558,21704
874284,U48420,2,B24,2024-07-15 05:41:47,11979,6919,2249,558,21705
874683,U48420,1,B21,2024-07-15 05:44:44,41495,22793,8091,1579,73958
877841,U48420,1,B18,2024-07-15 06:12:53,16988,9761,2574,622,29945
877842,U48420,4,B18,2024-07-15 06:12:53,16988,9761,2574,623,29946
889287,U48420,1,B3,2024-07-15 11:13:34,13876,7554,2552,926,24908
889549,U48420,1,B27,2024-07-15 11:30:23,6744,3754,1326,440,12264
889550,U48420,3,B27,2024-07-15 11:30:23,6744,3754,1327,440,12265
889567,U48420,1,B21,2024-07-15 11:33:19,42301,23051,8144,1592,75088
889695,U48420,2,B20,2024-07-15 11:44:04,14837,9523,3654,795,28809
889696,U48420,1,B20,2024-07-15 11:44:04,14838,9523,3654,795,28810
889705,U48420,1,B18,2024-07-15 11:44:20,17294,9907,2606,643,30450
889730,U48420,1,B19,2024-07-15 11:46:12,14942,9256,2879,642,27719
889731,U48420,2,B19,2024-07-15 11:46:12,14942,9257,2879,642,27720
906411,U48420,3,B5,2024-07-15 15:19:18,42849,27219,7479,1758,79305
906415,U48420,1,B5,2024-07-15 15:19:18,42850,27219,7479,1758,79306
907302,U48420,3,B60,2024-07-15 15:22:07,16945,7120,3899,808,28772
907303,U48420,1,B60,2024-07-15 15:22:07,16946,7120,3899,808,28773
907389,U48420,1,B21,2024-07-15 15:22:16,42874,23326,8260,1621,76081
911313,U48420,1,B2,2024-07-15 15:36:04,16508,8611,3243,882,29244
911314,U48420,3,B2,2024-07-15 15:36:04,16508,8611,3244,882,29245
916902,U48420,4,B7,2024-07-15 15:57:09,16105,9501,3144,889,29639
916903,U48420,1,B7,2024-07-15 15:57:09,16106,9501,3144,889,29640
919385,U48420,1,B12,2024-07-15 16:04:48,14430,6942,2592,837,24801
919386,U48420,2,B12,2024-07-15 16:04:48,14430,6943,2592,837,24802
920586,U48420,1,B13,2024-07-15 16:07:52,19174,10994,3637,1125,34930
920587,U48420,2,B13,2024-07-15 16:07:52,19174,10995,3637,1125,34931
922371,U48420,2,B8,2024-07-15 16:12:43,7108,4902,1161,454,13625
922373,U48420,1,B8,2024-07-15 16:12:43,7109,4902,1161,454,13626
923037,U48420,2,B3,2024-07-15 16:14:59,14330,7799,2612,942,25683
923044,U48420,1,B3,2024-07-15 16:14:59,14331,7799,2612,942,25684
924834,U9,3,B13,2024-07-15 16:20:50,19261,11051,3658,1128,35098
924841,U9,1,B13,2024-07-15 16:20:50,19262,11051,3658,1128,35099
926879,U9,1,B8,2024-07-15 16:27:51,7158,4932,1177,456,13723
926880,U9,3,B8,2024-07-15 16:27:51,7158,4932,1178,456,13724
930117,U48420,1,B68,2024-07-15 16:37:21,4013,1338,714,248,6313
930118,U48420,3,B68,2024-07-15 16:37:21,4013,1338,715,248,6314
933671,U9,1,B68,2024-07-15 16:48:18,4024,1344,718,249,6335
936528,U48420,1,B15,2024-07-15 16:57:59,32982,17250,7177,1350,58759
936529,U48420,2,B15,2024-07-15 16:57:59,32982,17251,7177,1350,58760
937990,U48420,2,B25,2024-07-15 17:02:31,9970,7434,1520,561,19485
937992,U48420,1,B25,2024-07-15 17:02:31,9971,7434,1520,561,19486
939396,U48420,1,B23,2024-07-15 17:06:35,15463,8874,2586,920,27843
939400,U48420,2,B23,2024-07-15 17:06:35,15463,8875,2586,920,27844
941417,U48420,1,B6,2024-07-15 17:12:39,8318,4558,1338,520,14734
946549,U48420,1,B7,2024-07-15 17:37:45,16600,9828,3238,905,30571
946550,U48420,2,B7,2024-07-15 17:37:45,16600,9829,3238,905,30572
947083,U48420,1,B21,2024-07-15 17:40:30,44705,24442,8714,1721,79582
947086,U48420,2,B21,2024-07-15 17:40:30,44705,24443,8714,1721,79583
948073,U48420,2,B23,2024-07-15 17:44:56,15599,8959,2610,928,28096
948075,U48420,1,B23,2024-07-15 17:44:56,15600,8959,2610,928,28097
953042,U48420,3,B34,2024-07-15 18:02:51,6758,3346,1378,526,12008
953043,U48420,1,B34,2024-07-15 18:02:51,6759,3346,1378,526,12009
953634,U48420,1,B24,2024-07-15 18:04:55,13093,7525,2498,642,23758
953635,U48420,2,B24,2024-07-15 18:04:55,13093,7526,2498,642,23759
954080,U48420,2,B25,2024-07-15 18:06:13,10184,7602,1544,573,19903
954084,U48420,1,B25,2024-07-15 18:06:13,10185,7602,1544,573,19904
955368,U48420,1,B17,2024-07-15 18:10:21,10456,7359,2748,434,20997
956271,U48420,1,B10,2024-07-15 18:13:32,8779,6708,1778,294,17559
956272,U48420,2,B10,2024-07-15 18:13:32,8779,6709,1778,294,17560
956815,U48420,1,B35,2024-07-15 18:15:27,5529,4093,1273,241,11136
956816,U48420,2,B35,2024-07-15 18:15:27,5529,4094,1273,241,11137
962522,U48420,4,B43,2024-07-15 18:37:31,6772,4845,1639,239,13495
962523,U48420,3,B43,2024-07-15 18:37:31,6772,4845,1640,239,13496
962525,U48420,1,B43,2024-07-15 18:37:31,6773,4845,1640,239,13497
962709,U48420,2,B52,2024-07-15 18:38:15,9061,6472,2250,259,18042
962717,U48420,1,B52,2024-07-15 18:38:15,9062,6472,2250,259,18043
962922,U48420,2,B42,2024-07-15 18:38:59,9672,6342,2650,267,18931
962929,U48420,1,B42,2024-07-15 18:38:59,9673,6342,2650,267,18932
963172,U48420,1,B47,2024-07-15 18:39:51,12739,9474,2915,312,25440
963173,U48420,2,B47,2024-07-15 18:39:51,12739,9475,2915,312,25441
963351,U48420,1,B44,2024-07-15 18:40:37,13470,8372,3446,750,26038
963352,U48420,2,B44,2024-07-15 18:40:37,13470,8373,3446,750,26039
963467,U48420,1,B59,2024-07-15 18:41:01,15675,10550,4580,471,31276
963468,U48420,2,B59,2024-07-15 18:41:01,15675,10551,4580,471,31277
963960,U48420,1,B45,2024-07-15 18:43:10,13282,9133,3436,551,26402
963961,U48420,3,B45,2024-07-15 18:43:10,13282,9133,3437,551,26403
965274,U48420,1,B13,2024-07-15 18:48:47,20108,11574,3837,1182,36701
965275,U48420,2,B13,2024-07-15 18:48:47,20108,11575,3837,1182,36702
966261,U48420,1,B8,2024-07-15 18:52:59,7477,5168,1242,473,14360
966265,U48420,2,B8,2024-07-15 18:52:59,7477,5169,1242,473,14361
966493,U48420,1,B3,2024-07-15 18:53:55,14843,8133,2717,968,26661
970453,U48420,2,B72,2024-07-15 19:09:14,12376,6006,1793,742,20917
970454,U48420,1,B72,2024-07-15 19:09:14,12377,6006,1793,742,20918
971982,U48420,2,B15,2024-07-15 19:14:45,34073,17809,7438,1391,60711
971984,U48420,1,B15,2024-07-15 19:14:45,34074,17809,7438,1391,60712
972904,U48420,1,B60,2024-07-15 19:17:54,17620,7398,4087,852,29957
973051,U48420,2,B5,2024-07-15 19:18:28,45718,29193,8045,1877,84833
973053,U48420,1,B5,2024-07-15 19:18:28,45719,29193,8045,1877,84834
973823,U48420,1,B2,2024-07-15 19:21:08,17600,9198,3461,928,31187
973826,U48420,3,B2,2024-07-15 19:21:08,17600,9198,3462,928,31188
974439,U48420,1,B6,2024-07-15 19:23:17,8760,4831,1395,542,15528
1008712,U48420,2,B5,2024-07-15 22:05:10,47381,30362,8338,1943,88024
1008713,U48420,1,B5,2024-07-15 22:05:10,47382,30362,8338,1943,88025
1009307,U48420,1,B2,2024-07-15 22:07:50,18394,9643,3622,955,32614
1009308,U48420,3,B2,2024-07-15 22:07:50,18394,9643,3623,955,32615
1010120,U48420,1,B21,2024-07-15 22:11:09,47476,26067,9290,1822,84655
1010725,U48420,3,B60,2024-07-15 22:13:18,18542,7704,4323,890,31459
1010726,U48420,1,B60,2024-07-15 22:13:18,18543,7704,4323,890,31460
1011879,U48420,1,B3,2024-07-15 22:17:27,15927,8736,2857,1032,28552
1067567,U48420,1,B6,2024-07-16 02:00:55,10020,5491,1532,599,17642
1071796,U22405,1,B59,2024-07-16 02:11:58,17439,11884,4970,509,34802
1071797,U22405,2,B59,2024-07-16 02:11:58,17439,11885,4970,509,34803
1072246,U22405,4,B44,2024-07-16 02:13:26,14987,9123,3837,843,28790
1072247,U22405,1,B44,2024-07-16 02:13:26,14988,9123,3837,843,28791
1072419,U22405,1,B47,2024-07-16 02:14:05,14194,10247,3576,355,28372
1072420,U22405,2,B47,2024-07-16 02:14:05,14194,10248,3576,355,28373
1072611,U22405,1,B42,2024-07-16 02:14:43,10938,7115,2961,299,21313
1072614,U22405,2,B42,2024-07-16 02:14:43,10938,7116,2961,299,21314
1072854,U22405,2,B52,2024-07-16 02:15:27,10176,7220,2579,294,20269
1072856,U22405,1,B52,2024-07-16 02:15:27,10177,7220,2579,294,20270
1073042,U22405,1,B43,2024-07-16 02:16:07,7582,5395,1849,273,15099
1073048,U22405,2,B43,2024-07-16 02:16:07,7582,5396,1849,273,15100
1073537,U22405,2,B46,2024-07-16 02:17:48,4607,3228,1256,132,9223
1073538,U22405,1,B46,2024-07-16 02:17:48,4608,3228,1256,132,9224
1074595,U48420,1,B5,2024-07-16 02:22:12,50314,32356,8967,2075,93712
1074598,U48420,2,B5,2024-07-16 02:22:12,50314,32357,8967,2075,93713
1074995,U48420,1,B21,2024-07-16 02:24:22,50278,27698,9951,1964,89891
1074996,U48420,2,B21,2024-07-16 02:24:22,50278,27699,9951,1964,89892
1167417,U9,2,B23,2024-07-16 15:58:39,18969,10798,3131,1107,34005
1167418,U9,1,B23,2024-07-16 15:58:39,18970,10798,3131,1107,34006
1170522,U9,4,B4,2024-07-16 16:05:17,21349,11164,4525,1280,38318
1170529,U9,1,B4,2024-07-16 16:05:17,21350,11164,4525,1280,38319
1172304,U9,1,B13,2024-07-16 16:08:50,24337,13899,4626,1415,44277
1179667,U9,3,B8,2024-07-16 16:24:04,9111,6285,1530,551,17477
1179670,U9,2,B8,2024-07-16 16:24:04,9111,6286,1530,551,17478
1179671,U9,1,B8,2024-07-16 16:24:04,9112,6286,1530,551,17479
1180599,U9,2,B3,2024-07-16 16:26:15,19381,10480,3349,1206,34416
1180600,U9,1,B3,2024-07-16 16:26:15,19382,10480,3349,1206,34417
1184862,U22405,1,B43,2024-07-16 16:44:01,8457,6040,2033,302,16832
1184863,U22405,2,B43,2024-07-16 16:44:01,8457,6041,2033,302,16833
1184975,U22405,1,B52,2024-07-16 16:44:36,11349,8089,2826,322,22586
1185114,U22405,1,B42,2024-07-16 16:45:18,12007,7802,3243,321,23373
1185115,U22405,2,B42,2024-07-16 16:45:18,12007,7803,3243,321,23374
1185251,U22405,2,B47,2024-07-16 16:45:55,15573,11132,4036,400,31141
1185252,U22405,1,B47,2024-07-16 16:45:55,15574,11132,4036,400,31142
1185385,U22405,1,B44,2024-07-16 16:46:31,16566,10022,4224,920,31732
1185388,U22405,2,B44,2024-07-16 16:46:31,16566,10023,4224,920,31733
1185503,U22405,2,B59,2024-07-16 16:46:59,19379,13399,5313,551,38642
1185504,U22405,1,B59,2024-07-16 16:46:59,19380,13399,5313,551,38643
1223122,U48420,1,B23,2024-07-16 19:56:40,19810,11326,3264,1153,35553
1223123,U48420,2,B23,2024-07-16 19:56:40,19810,11327,3264,1153,35554
1223574,U48420,1,B24,2024-07-16 19:58:51,16365,9413,3088,767,29633
1223575,U48420,3,B24,2024-07-16 19:58:51,16365,9413,3089,767,29634
1227230,U48420,3,B15,2024-07-16 20:15:03,43041,22406,9547,1790,76784
1227232,U48420,1,B15,2024-07-16 20:15:03,43042,22406,9547,1790,76785
1227835,U48420,3,B21,2024-07-16 20:17:47,57551,32279,11643,2340,103813
1227836,U48420,1,B21,2024-07-16 20:17:47,57552,32279,11643,2340,103814
1228924,U48420,1,B76,2024-07-16 20:23:19,12891,7276,1956,846,22969
1240861,U48420,1,B13,2024-07-16 21:41:32,25787,14818,4862,1520,46987
1240864,U48420,3,B13,2024-07-16 21:41:32,25788,14819,4863,1520,46990
1241342,U48420,1,B15,2024-07-16 21:44:02,43588,22685,9676,1810,77759
1241345,U48420,2,B15,2024-07-16 21:44:02,43588,22686,9676,1810,77760
1243083,U48420,3,B21,2024-07-16 21:52:24,58311,32743,11831,2358,105243
1243084,U48420,4,B21,2024-07-16 21:52:24,58311,32743,11831,2359,105244
1243085,U48420,1,B21,2024-07-16 21:52:24,58312,32743,11831,2359,105245
1243564,U48420,2,B23,2024-07-16 21:54:56,20154,11522,3320,1169,36165
1243565,U48420,1,B23,2024-07-16 21:54:56,20155,11522,3320,1169,36166
1243915,U16,1,B4,2024-07-16 21:56:24,22746,11902,4814,1359,40821
1244000,U16,1,B3,2024-07-16 21:56:51,20602,11336,3581,1277,36796
1244435,U16,2,B2,2024-07-16 21:59:23,22806,12054,4459,1165,40484
1244436,U16,1,B2,2024-07-16 21:59:23,22807,12054,4459,1165,40485
1246838,U16,2,B24,2024-07-16 22:11:24,16674,9582,3150,796,30202
1246841,U16,1,B24,2024-07-16 22:11:24,16675,9582,3150,796,30203
1247428,U48420,4,B4,2024-07-16 22:15:11,22816,11939,4824,1363,40942
1247431,U48420,1,B4,2024-07-16 22:15:11,22817,11939,4824,1363,40943
1247433,U48420,2,B4,2024-07-16 22:15:11,22817,11940,4824,1363,40944
1247434,U48420,3,B4,2024-07-16 22:15:11,22817,11940,4825,1363,40945
1247631,U48420,2,B5,2024-07-16 22:16:29,58766,38159,10531,2417,109873
1247632,U48420,1,B5,2024-07-16 22:16:29,58767,38159,10531,2417,109874
1248287,U16,3,B13,2024-07-16 22:20:43,25959,14928,4892,1529,47308
1248288,U16,1,B13,2024-07-16 22:20:43,25960,14928,4892,1529,47309
1254076,U9,1,B22,2024-07-16 22:46:19,2615,1293,489,243,4640
1254420,U48420,1,B15,2024-07-16 22:47:31,44064,22932,9781,1824,78601
1255163,U9,1,B8,2024-07-16 22:50:08,9911,6886,1676,606,19079
1255253,U48420,2,B25,2024-07-16 22:50:25,13035,9649,1999,740,25423
1255258,U48420,1,B25,2024-07-16 22:50:25,13036,9649,1999,740,25424
1256388,U9,1,B2,2024-07-16 22:54:19,23050,12180,4508,1176,40914
1256390,U9,2,B2,2024-07-16 22:54:19,23050,12181,4508,1176,40915
1256650,U9,1,B4,2024-07-16 22:55:18,22989,12045,4855,1371,41260
1257394,U9,1,B24,2024-07-16 22:57:54,16816,9665,3175,800,30456
1258647,U48420,1,B7,2024-07-16 23:02:31,22066,13087,4244,1206,40603
1258649,U48420,2,B7,2024-07-16 23:02:31,22066,13088,4244,1206,40604
1258985,U48420,1,B27,2024-07-16 23:03:36,9182,5061,1782,596,16621
1260039,U9,1,B3,2024-07-16 23:07:11,20937,11547,3630,1297,37411
1260749,U48420,1,B6,2024-07-16 23:09:53,11282,6107,1702,681,19772
1260923,U48420,1,B3,2024-07-16 23:10:31,20966,11564,3634,1298,37462
1261504,U48420,1,B2,2024-07-16 23:12:45,23167,12250,4521,1181,41119
1261505,U48420,2,B2,2024-07-16 23:12:45,23167,12251,4521,1181,41120
1261706,U48420,2,B5,2024-07-16 23:13:38,59412,38610,10667,2429,111118
1261709,U48420,1,B5,2024-07-16 23:13:38,59413,38610,10667,2429,111119
1263229,U9,1,B27,2024-07-16 23:20:43,9224,5082,1790,600,16696
1263231,U9,3,B27,2024-07-16 23:20:43,9224,5082,1791,600,16697
1263581,U9,1,B7,2024-07-16 23:22:10,22156,13140,4255,1214,40765
1267854,U48420,4,B24,2024-07-16 23:43:11,16972,9766,3194,813,30745
1267855,U48420,1,B24,2024-07-16 23:43:11,16973,9766,3194,813,30746
1268064,U48420,1,B23,2024-07-16 23:44:17,20596,11782,3378,1189,36945
1273508,U48420,1,B53,2024-07-17 00:05:49,2283,1452,584,174,4493
1273510,U48420,2,B53,2024-07-17 00:05:49,2283,1453,584,174,4494
1280053,U9,3,B76,2024-07-17 00:32:52,13437,7607,2037,880,23961
1280056,U9,1,B76,2024-07-17 00:32:52,13438,7607,2037,880,23962
1280057,U9,2,B76,2024-07-17 00:32:52,13438,7608,2037,880,23963
1283578,U48420,1,B3,2024-07-17 00:48:43,21377,11802,3678,1316,38173
1284584,U48420,1,B2,2024-07-17 00:52:24,23634,12501,4602,1207,41944
1284585,U48420,2,B2,2024-07-17 00:52:24,23634,12502,4602,1207,41945
1284768,U48420,2,B5,2024-07-17 00:53:13,60398,39302,10819,2467,112986
1284770,U48420,1,B5,2024-07-17 00:53:13,60399,39302,10819,2467,112987
1285218,U48420,1,B4,2024-07-17 00:54:48,23530,12338,4974,1409,42251
1303316,U22405,2,B59,2024-07-17 01:51:58,21149,14627,5772,651,42199
1303317,U22405,1,B59,2024-07-17 01:51:58,21150,14627,5772,651,42200
1303544,U22405,1,B44,2024-07-17 01:52:29,18173,11090,4597,986,34846
1303545,U22405,2,B44,2024-07-17 01:52:29,18173,11091,4597,986,34847
1303732,U22405,2,B47,2024-07-17 01:53:01,17188,12428,4342,432,34390
1303733,U22405,1,B47,2024-07-17 01:53:01,17189,12428,4342,432,34391
1304131,U22405,2,B42,2024-07-17 01:54:02,13215,8653,3533,357,25758
1304134,U22405,1,B42,2024-07-17 01:54:02,13216,8653,3533,357,25759
1304510,U22405,1,B52,2024-07-17 01:54:47,12382,8809,3113,368,24672
1304511,U22405,2,B52,2024-07-17 01:54:47,12382,8810,3113,368,24673
1305416,U22405,1,B46,2024-07-17 01:57:11,5580,3920,1503,153,11156
1305417,U22405,2,B46,2024-07-17 01:57:11,5580,3921,1503,153,11157
1321817,U48420,2,B3,2024-07-17 02:42:53,22027,12178,3815,1375,39395
1321820,U48420,1,B3,2024-07-17 02:42:53,22028,12178,3816,1375,39397
1322747,U48420,2,B2,2024-07-17 02:45:40,24302,12867,4774,1234,43177
1322751,U48420,1,B2,2024-07-17 02:45:40,24303,12867,4774,1234,43178
1323029,U48420,2,B5,2024-07-17 02:46:29,62116,40424,11481,2671,116692
1323030,U48420,1,B5,2024-07-17 02:46:29,62117,40424,11481,2671,116693
1324195,U48420,2,B4,2024-07-17 02:49:56,24231,12735,5130,1435,43531
1324196,U48420,1,B4,2024-07-17 02:49:56,24232,12735,5130,1435,43532
1331604,U48420,4,B60,2024-07-17 03:16:12,26451,10612,6210,1313,44586
1331607,U48420,1,B60,2024-07-17 03:16:12,26452,10612,6210,1313,44587
1331709,U48420,2,B21,2024-07-17 03:16:44,62299,35101,12892,2543,112835
1331713,U48420,1,B21,2024-07-17 03:16:44,62301,35101,12893,2543,112838
1331917,U48420,1,B15,2024-07-17 03:17:37,46497,24201,10413,2005,83116
1335878,U48420,2,B15,2024-07-17 03:40:02,46626,24282,10438,2008,83354
1335881,U48420,1,B15,2024-07-17 03:40:02,46627,24282,10438,2008,83355
1336231,U48420,2,B21,2024-07-17 03:41:45,62524,35254,12933,2549,113260
1336232,U48420,1,B21,2024-07-17 03:41:45,62525,35254,12933,2549,113261
1336883,U48420,3,B5,2024-07-17 03:44:52,62780,40899,11610,2725,118014
1336885,U48420,1,B5,2024-07-17 03:44:52,62781,40899,11610,2725,118015
1337664,U48420,1,B2,2024-07-17 03:48:15,24573,13022,4822,1243,43660
1337665,U48420,3,B2,2024-07-17 03:48:15,24573,13022,4823,1243,43661
1338266,U48420,3,B3,2024-07-17 03:50:52,22467,12436,3879,1392,40174
1338267,U48420,1,B3,2024-07-17 03:50:52,22468,12436,3879,1392,40175
1390060,U48420,1,B2,2024-07-17 15:30:20,25554,13435,4970,1285,45244
1390063,U48420,2,B2,2024-07-17 15:30:20,25554,13436,4970,1285,45245
1390258,U48420,2,B5,2024-07-17 15:31:07,65804,43001,11997,2799,123601
1390259,U48420,1,B5,2024-07-17 15:31:07,65805,43001,11997,2799,123602
1390413,U48420,1,B60,2024-07-17 15:31:53,29211,11581,6806,1400,48998
1390533,U48420,1,B21,2024-07-17 15:32:14,65615,37173,13406,2641,118835
1390537,U48420,2,B21,2024-07-17 15:32:14,65617,37175,13406,2641,118839
1390879,U48420,1,B15,2024-07-17 15:33:25,48945,25459,10851,2082,87337
1390884,U48420,2,B15,2024-07-17 15:33:25,48946,25461,10851,2082,87340
1394857,U48420,4,B17,2024-07-17 15:47:29,15010,10694,3837,598,30139
1394860,U48420,1,B17,2024-07-17 15:47:29,15011,10694,3837,598,30140
1405270,U48420,3,B20,2024-07-17 16:21:50,23257,14845,5577,1228,44907
1405271,U48420,1,B20,2024-07-17 16:21:50,23258,14845,5577,1228,44908
1405437,U48420,2,B18,2024-07-17 16:22:33,27288,15785,4249,1031,48353
1405441,U48420,1,B18,2024-07-17 16:22:33,27289,15785,4249,1031,48354
1411110,U48420,2,B53,2024-07-17 16:43:46,2450,1552,632,187,4821
1411114,U48420,1,B53,2024-07-17 16:43:46,2451,1552,632,187,4822
1418089,U16,1,B4,2024-07-17 17:12:13,26078,13630,5465,1525,46698
1418091,U16,2,B4,2024-07-17 17:12:13,26078,13631,5465,1525,46699
1418689,U16,1,B2,2024-07-17 17:15:22,26120,13755,5099,1313,46287
1424812,U48420,1,B2,2024-07-17 17:47:14,26269,13842,5131,1323,46565
1424814,U48420,2,B2,2024-07-17 17:47:14,26269,13843,5131,1323,46566
1425047,U48420,1,B5,2024-07-17 17:48:20,67906,44433,12619,2919,127877
1425050,U48420,3,B5,2024-07-17 17:48:20,67906,44433,12620,2919,127878
1425227,U48420,1,B60,2024-07-17 17:49:07,30994,12292,7292,1518,52096
1425906,U16,1,B23,2024-07-17 17:52:42,23038,13146,3809,1363,41356
1425907,U16,2,B23,2024-07-17 17:52:42,23038,13147,3809,1363,41357
1425908,U16,3,B23,2024-07-17 17:52:42,23038,13147,3810,1363,41358
1426042,U16,1,B24,2024-07-17 17:53:31,18978,10964,3592,901,34435
1428157,U16,2,B7,2024-07-17 18:04:19,24995,14818,4842,1403,46058
1428160,U16,1,B7,2024-07-17 18:04:19,24996,14818,4842,1403,46059
1432256,U48420,1,B19,2024-07-17 18:21:11,23564,14618,4361,1002,43545
1432257,U48420,3,B19,2024-07-17 18:21:11,23564,14618,4362,1002,43546
1450137,U48420,2,B7,2024-07-17 19:47:29,25366,15071,4920,1428,46785
1450139,U48420,1,B7,2024-07-17 19:47:29,25367,15071,4920,1428,46786
1450501,U48420,1,B8,2024-07-17 19:49:26,11562,8012,1994,729,22297
1450502,U48420,2,B8,2024-07-17 19:49:26,11562,8013,1994,729,22298
1450722,U48420,1,B3,2024-07-17 19:50:35,24900,13921,4260,1514,44595
1456182,U9,1,B3,2024-07-17 20:14:34,25021,14006,4274,1521,44822
1456183,U9,3,B3,2024-07-17 20:14:34,25021,14006,4275,1521,44823
1456335,U48420,1,B21,2024-07-17 20:15:20,69330,39578,14401,2874,126183
1456336,U48420,2,B21,2024-07-17 20:15:20,69330,39579,14401,2874,126184
1456337,U48420,3,B21,2024-07-17 20:15:20,69330,39579,14402,2874,126185
1456575,U48420,1,B15,2024-07-17 20:16:16,51707,26839,11594,2198,92338
1456576,U48420,2,B15,2024-07-17 20:16:16,51707,26840,11594,2198,92339
1458391,U48420,3,B72,2024-07-17 20:23:35,17055,8293,2486,1040,28874
1458395,U48420,1,B72,2024-07-17 20:23:35,17056,8293,2486,1040,28875
1458984,U22405,3,B43,2024-07-17 20:26:07,9811,7002,2382,381,19576
1458986,U22405,1,B43,2024-07-17 20:26:07,9812,7002,2382,381,19577
1459025,U16,1,B24,2024-07-17 20:26:19,19429,11240,3646,915,35230
1459026,U16,2,B24,2024-07-17 20:26:19,19429,11241,3646,915,35231
1459175,U22405,2,B52,2024-07-17 20:27:10,13470,9602,3339,403,26814
1459176,U22405,1,B52,2024-07-17 20:27:10,13471,9602,3339,403,26815
1459367,U22405,2,B42,2024-07-17 20:28:06,14052,9192,3774,385,27403
1459368,U22405,1,B42,2024-07-17 20:28:06,14053,9192,3774,385,27404
1459497,U22405,2,B47,2024-07-17 20:28:46,18660,13508,4660,489,37317
1459499,U22405,1,B47,2024-07-17 20:28:46,18661,13508,4660,489,37318
1459771,U22405,3,B44,2024-07-17 20:30:09,19423,11898,4867,1041,37229
1459773,U22405,1,B44,2024-07-17 20:30:09,19424,11898,4867,1041,37230
1459870,U22405,1,B59,2024-07-17 20:30:47,22606,15679,6076,708,45069
1459872,U22405,2,B59,2024-07-17 20:30:47,22606,15680,6076,708,45070
1459948,U16,1,B13,2024-07-17 20:31:24,30296,17442,5686,1788,55212
1459949,U16,2,B13,2024-07-17 20:31:24,30296,17443,5686,1788,55213
1460028,U22405,1,B45,2024-07-17 20:31:50,19094,13209,4910,757,37970
1460033,U22405,2,B45,2024-07-17 20:31:50,19094,13210,4910,757,37971
1462315,U16,4,B8,2024-07-17 20:44:02,11667,8083,2012,733,22495
1462316,U16,1,B8,2024-07-17 20:44:02,11668,8083,2012,733,22496
1464139,U9,1,B12,2024-07-17 20:54:28,22518,11065,3959,1325,38867
1465447,U16,3,B4,2024-07-17 21:02:57,27097,14162,5649,1596,48504
1465448,U16,1,B4,2024-07-17 21:02:57,27098,14162,5649,1596,48505
1466070,U16,1,B23,2024-07-17 21:06:52,23695,13519,3910,1406,42530
1466071,U16,3,B23,2024-07-17 21:06:52,23695,13519,3911,1406,42531
1496732,U9,1,B13,2024-07-17 23:35:52,31138,17926,5825,1843,56732
1496733,U9,3,B13,2024-07-17 23:35:52,31138,17926,5826,1843,56733
1497342,U48420,1,B3,2024-07-17 23:38:29,25847,14500,4412,1572,46331
1497912,U48420,2,B2,2024-07-17 23:40:48,27764,14684,5408,1398,49254
1497918,U48420,1,B2,2024-07-17 23:40:48,27765,14684,5408,1398,49255
1498114,U48420,1,B5,2024-07-17 23:41:32,71463,47065,13227,3052,134807
1498116,U48420,2,B5,2024-07-17 23:41:32,71463,47066,13227,3052,134808
1498688,U9,1,B68,2024-07-17 23:43:35,5378,2086,1193,428,9085
1499235,U48420,3,B60,2024-07-17 23:45:27,33738,13340,8032,1643,56753
1499243,U48420,1,B60,2024-07-17 23:45:27,33739,13340,8032,1643,56754
1499244,U48420,2,B60,2024-07-17 23:45:27,33739,13341,8032,1643,56755
1499349,U48420,1,B21,2024-07-17 23:45:47,71460,40943,14792,2961,130156
1499350,U48420,2,B21,2024-07-17 23:45:47,71460,40944,14792,2961,130157
1499632,U48420,2,B15,2024-07-17 23:46:46,53255,27616,11913,2252,95036
1499634,U48420,1,B15,2024-07-17 23:46:46,53256,27616,11913,2252,95037
1500265,U9,1,B3,2024-07-17 23:49:11,25926,14541,4419,1576,46462
1500719,U9,2,B6,2024-07-17 23:50:55,12772,6897,1932,764,22365
1500720,U9,1,B6,2024-07-17 23:50:55,12773,6897,1932,764,22366
1503680,U48420,1,B72,2024-07-18 00:03:42,17607,8567,2585,1093,29852
1503681,U48420,2,B72,2024-07-18 00:03:42,17607,8568,2585,1093,29853
1503682,U48420,3,B72,2024-07-18 00:03:42,17607,8568,2586,1093,29854
1504210,U48420,1,B13,2024-07-18 00:05:50,31290,18026,5850,1851,57017
1504811,U9,2,B8,2024-07-18 00:08:31,12098,8367,2065,752,23282
1504812,U9,1,B8,2024-07-18 00:08:31,12099,8367,2065,752,23283
1505169,U48420,1,B7,2024-07-18 00:09:54,26444,15736,5101,1477,48758
1505173,U48420,2,B7,2024-07-18 00:09:54,26444,15737,5101,1477,48759
1505530,U48420,1,B27,2024-07-18 00:11:32,10410,5760,2021,680,18871
1505531,U48420,2,B27,2024-07-18 00:11:32,10410,5761,2021,680,18872
1523072,U48420,3,B5,2024-07-18 01:20:20,72568,47829,13455,3094,136946
1523073,U48420,1,B5,2024-07-18 01:20:20,72569,47829,13455,3094,136947
1523299,U48420,1,B2,2024-07-18 01:20:59,28238,14906,5516,1424,50084
1523777,U48420,1,B3,2024-07-18 01:22:19,26289,14750,4471,1597,47107
1523781,U48420,2,B3,2024-07-18 01:22:19,26289,14751,4471,1597,47108
1524078,U48420,1,B6,2024-07-18 01:23:04,13057,7070,1976,778,22881
1538655,U48420,1,B3,2024-07-18 02:07:07,26497,14906,4494,1605,47502
1540307,U48420,2,B2,2024-07-18 02:10:55,28541,15074,5599,1434,50648
1540308,U48420,1,B2,2024-07-18 02:10:55,28542,15074,5599,1434,50649
1540649,U48420,1,B5,2024-07-18 02:11:49,73346,48263,13771,3170,138550
1540651,U48420,2,B5,2024-07-18 02:11:49,73346,48264,13771,3170,138551
1543815,U48420,4,B20,2024-07-18 02:20:20,25429,16268,6120,1342,49159
1543817,U48420,1,B20,2024-07-18 02:20:20,25430,16268,6120,1342,49160
1544019,U48420,2,B18,2024-07-18 02:20:59,29973,17366,4841,1160,53340
1544020,U48420,1,B18,2024-07-18 02:20:59,29974,17366,4841,1160,53341
1544768,U48420,3,B19,2024-07-18 02:23:19,25225,15753,4630,1079,46687
1544769,U48420,1,B19,2024-07-18 02:23:19,25226,15753,4630,1079,46688
1546713,U48420,1,B26,2024-07-18 02:29:15,11779,5123,2031,801,19734
1546715,U48420,2,B26,2024-07-18 02:29:15,11779,5124,2031,801,19735
1546719,U48420,3,B26,2024-07-18 02:29:15,11779,5124,2032,801,19736
1590068,U48420,1,B7,2024-07-18 05:54:06,27977,16634,5478,1606,51695
1591080,U48420,2,B8,2024-07-18 06:01:35,12892,8915,2229,795,24831
1591081,U48420,1,B8,2024-07-18 06:01:35,12893,8915,2229,795,24832
1591084,U48420,3,B8,2024-07-18 06:01:35,12894,8915,2231,795,24835
1591698,U48420,1,B2,2024-07-18 06:06:17,29407,15534,5794,1487,52222
1591699,U48420,2,B2,2024-07-18 06:06:17,29407,15535,5794,1487,52223
1591813,U48420,1,B5,2024-07-18 06:07:05,75787,49882,14384,3324,143377
1591815,U48420,2,B5,2024-07-18 06:07:05,75787,49883,14384,3324,143378
1593629,U48420,1,B6,2024-07-18 06:22:03,13646,7380,2067,806,23899
1632982,U48420,1,B13,2024-07-18 16:11:26,34097,19631,6414,2035,62177
1632988,U48420,2,B13,2024-07-18 16:11:26,34097,19632,6414,2035,62178
1634172,U48420,2,B8,2024-07-18 16:15:38,13157,9023,2259,806,25245
1634173,U48420,1,B8,2024-07-18 16:15:38,13158,9023,2259,806,25246
1634411,U48420,1,B3,2024-07-18 16:16:27,28556,16096,4786,1677,51115
1636934,U48420,1,B26,2024-07-18 16:26:06,12607,5487,2168,840,21102
1636935,U48420,2,B26,2024-07-18 16:26:06,12607,5488,2168,840,21103
1637443,U48420,1,B19,2024-07-18 16:27:56,26897,16799,4930,1152,49778
1637444,U48420,2,B19,2024-07-18 16:27:56,26897,16800,4930,1152,49779
1645888,U48420,1,B60,2024-07-18 17:01:21,38292,14978,9095,1867,64232
1645889,U48420,3,B60,2024-07-18 17:01:21,38292,14978,9096,1867,64233
1645977,U48420,1,B21,2024-07-18 17:01:41,78513,45221,16253,3296,143283
1645979,U48420,2,B21,2024-07-18 17:01:41,78514,45222,16253,3296,143285
1647385,U48420,1,B13,2024-07-18 17:06:57,34372,19805,6462,2048,62687
1647388,U48420,2,B13,2024-07-18 17:06:57,34372,19806,6462,2048,62688
1653335,U48420,1,B72,2024-07-18 17:30:11,19200,9328,2846,1194,32568
1653336,U48420,2,B72,2024-07-18 17:30:11,19200,9329,2846,1194,32569
1653337,U48420,4,B72,2024-07-18 17:30:11,19200,9329,2846,1195,32570
1655174,U48420,1,B23,2024-07-18 17:37:52,26662,15145,4466,1607,47880
1655175,U48420,2,B23,2024-07-18 17:37:52,26662,15146,4466,1607,47881
1672320,U9,1,B13,2024-07-18 18:50:04,34918,20149,6568,2096,63731
1673229,U9,1,B8,2024-07-18 18:54:10,13496,9300,2312,828,25936
1673234,U9,2,B8,2024-07-18 18:54:10,13496,9301,2312,828,25937
1677358,U9,2,B72,2024-07-18 19:13:30,19438,9470,2895,1218,33021
1677359,U9,1,B72,2024-07-18 19:13:30,19439,9470,2895,1218,33022
1683410,U9,1,B76,2024-07-18 19:40:16,18181,10454,2702,1169,32506
1689653,U9,2,B24,2024-07-18 20:08:27,22321,12988,4274,1140,40723
1689654,U9,3,B24,2024-07-18 20:08:27,22321,12988,4275,1140,40724
1689655,U9,1,B24,2024-07-18 20:08:27,22322,12988,4275,1140,40725
1689886,U48420,1,B76,2024-07-18 20:09:35,18265,10503,2715,1173,32656
1689888,U48420,4,B76,2024-07-18 20:09:35,18265,10503,2715,1174,32657
1690038,U48420,1,B4,2024-07-18 20:10:10,31233,16244,6474,1824,55775
1690475,U9,1,B4,2024-07-18 20:12:11,31242,16252,6474,1824,55792
1691274,U48420,2,B21,2024-07-18 20:15:37,80716,46805,16654,3422,147597
1691275,U48420,1,B21,2024-07-18 20:15:37,80717,46805,16654,3422,147598
1692299,U48420,1,B3,2024-07-18 20:20:29,29662,16850,4998,1739,53249
1693578,U9,3,B2,2024-07-18 20:27:40,31262,16436,6122,1590,55410
1693579,U9,1,B2,2024-07-18 20:27:40,31263,16436,6122,1590,55411
1696460,U48420,1,B5,2024-07-18 20:48:55,80929,53542,15154,3528,153153
1696462,U48420,2,B5,2024-07-18 20:48:55,80929,53543,15154,3528,153154
1696811,U48420,1,B60,2024-07-18 20:50:57,40313,15728,9642,1975,67658
1696812,U48420,3,B60,2024-07-18 20:50:57,40313,15728,9643,1975,67659
1696879,U48420,1,B21,2024-07-18 20:51:23,81018,46982,16701,3432,148133
1696881,U48420,2,B21,2024-07-18 20:51:23,81018,46983,16701,3432,148134
1697683,U48420,1,B13,2024-07-18 20:55:51,35493,20514,6654,2121,64782
1701828,U48420,1,B2,2024-07-18 21:18:45,31451,16534,6166,1601,55752
1703687,U48420,2,B20,2024-07-18 21:30:25,28067,17877,6701,1567,54212
1703688,U48420,1,B20,2024-07-18 21:30:25,28068,17877,6701,1567,54213
1703878,U9,3,B23,2024-07-18 21:31:33,27382,15567,4598,1640,49187
1703879,U9,1,B23,2024-07-18 21:31:33,27383,15567,4598,1640,49188
1703907,U48420,1,B18,2024-07-18 21:31:46,33331,19380,5478,1325,59514
1703910,U48420,3,B18,2024-07-18 21:31:46,33331,19380,5479,1325,59515
1704041,U9,2,B24,2024-07-18 21:32:28,22540,13122,4302,1147,41111
1704042,U9,1,B24,2024-07-18 21:32:28,22541,13122,4302,1147,41112
1704060,U48420,1,B19,2024-07-18 21:32:36,27848,17412,5006,1201,51467
1707938,U9,3,B8,2024-07-18 21:53:54,13856,9559,2365,846,26626
1707939,U9,1,B8,2024-07-18 21:53:54,13857,9559,2365,846,26627
1708250,U9,2,B3,2024-07-18 21:55:30,30027,17072,5040,1751,53890
1708251,U9,1,B3,2024-07-18 21:55:30,30028,17072,5040,1751,53891
1715515,U9,1,B12,2024-07-18 22:33:54,26548,13011,4749,1593,45901
1715955,U9,1,B4,2024-07-18 22:35:59,31739,16488,6542,1848,56617
1720772,U9,1,B3,2024-07-18 23:02:53,30309,17275,5085,1769,54438
1720774,U9,4,B3,2024-07-18 23:02:53,30309,17275,5085,1770,54439
1721514,U9,1,B7,2024-07-18 23:06:57,30262,17998,5871,1769,55900
1721825,U9,1,B13,2024-07-18 23:08:36,36071,20870,6776,2173,65890
1722924,U9,3,B72,2024-07-18 23:14:49,20029,9770,2999,1259,34057
1722928,U9,1,B72,2024-07-18 23:14:49,20030,9770,2999,1259,34058
1725856,U48420,1,B3,2024-07-18 23:30:46,30411,17340,5097,1775,54623
1726624,U48420,1,B21,2024-07-18 23:34:47,82450,47898,17005,3502,150855
1726806,U48420,1,B15,2024-07-18 23:35:36,61336,31739,13991,2640,109706
1728660,U48420,1,B24,2024-07-18 23:45:32,22894,13335,4347,1159,41735
1728662,U48420,3,B24,2024-07-18 23:45:32,22894,13335,4348,1159,41736
1728663,U48420,2,B24,2024-07-18 23:45:32,22894,13336,4348,1159,41737
1728857,U48420,1,B23,2024-07-18 23:46:23,27788,15795,4667,1670,49920
1733748,U48420,1,B53,2024-07-19 00:11:27,3083,1924,814,247,6068
1733749,U48420,2,B53,2024-07-19 00:11:27,3083,1925,814,247,6069
1766344,U9,3,B6,2024-07-19 02:13:24,14175,7629,2155,845,24804
1766345,U9,2,B6,2024-07-19 02:13:24,14175,7630,2155,845,24805
1766348,U9,1,B6,2024-07-19 02:13:24,14176,7630,2155,845,24806
1766960,U22405,1,B59,2024-07-19 02:15:40,27382,19092,7297,928,54699
1766962,U22405,2,B59,2024-07-19 02:15:40,27382,19093,7297,928,54700
1767138,U22405,2,B44,2024-07-19 02:16:20,23761,14806,5815,1239,45621
1767139,U22405,1,B44,2024-07-19 02:16:20,23762,14806,5815,1239,45622
1767260,U22405,2,B47,2024-07-19 02:16:49,22800,16756,5442,576,45574
1767261,U22405,1,B47,2024-07-19 02:16:49,22801,16756,5442,576,45575
1767450,U22405,1,B42,2024-07-19 02:17:23,17156,11270,4630,463,33519
1767671,U22405,1,B52,2024-07-19 02:18:12,16680,11812,4208,523,33223
1767672,U22405,2,B52,2024-07-19 02:18:12,16680,11813,4208,523,33224
1768047,U22405,1,B43,2024-07-19 02:19:26,11938,8500,2946,477,23861
1768048,U22405,3,B43,2024-07-19 02:19:26,11938,8500,2947,477,23862
1768698,U22405,3,B46,2024-07-19 02:21:39,7273,5137,1964,204,14578
1768703,U22405,1,B46,2024-07-19 02:21:39,7274,5137,1964,204,14579
1772124,U48420,1,B6,2024-07-19 02:35:02,14241,7668,2169,850,24928
1775181,U48420,2,B27,2024-07-19 02:47:17,11616,6531,2255,777,21179
1775183,U48420,1,B27,2024-07-19 02:47:17,11617,6531,2255,777,21180
1776048,U48420,1,B13,2024-07-19 02:51:06,37295,21604,7032,2236,68167
1776709,U48420,1,B12,2024-07-19 02:53:58,27499,13560,4937,1676,47672
1776713,U48420,2,B12,2024-07-19 02:53:58,27499,13561,4937,1676,47673
1780181,U48420,2,B7,2024-07-19 03:08:17,31341,18689,6081,1835,57946
1780182,U48420,1,B7,2024-07-19 03:08:17,31342,18689,6081,1835,57947
1821352,U48420,1,B7,2024-07-19 08:26:05,32044,19119,6187,1868,59218
1821353,U48420,2,B7,2024-07-19 08:26:05,32044,19120,6187,1868,59219
1821459,U48420,2,B21,2024-07-19 08:28:55,86846,50593,17968,3692,159099
1821460,U48420,1,B21,2024-07-19 08:28:55,86847,50593,17968,3692,159100
1821505,U48420,1,B60,2024-07-19 08:29:50,44560,17406,10688,2154,74808
1821506,U48420,2,B60,2024-07-19 08:29:50,44560,17407,10688,2154,74809
1821539,U48420,2,B5,2024-07-19 08:30:24,86820,57723,16177,3751,164471
1821540,U48420,1,B5,2024-07-19 08:30:24,86821,57723,16177,3751,164472
1821595,U48420,1,B2,2024-07-19 08:31:57,33653,17685,6625,1709,59672
1821596,U48420,2,B2,2024-07-19 08:31:57,33653,17686,6625,1709,59673
1826173,U48420,1,B2,2024-07-19 11:57:33,33779,17722,6638,1714,59853
1826191,U48420,2,B3,2024-07-19 11:59:04,32831,18707,5383,1859,58780
1826192,U48420,1,B3,2024-07-19 11:59:04,32832,18707,5383,1859,58781
1826508,U48420,1,B27,2024-07-19 12:20:54,11955,6706,2338,806,21805
1826509,U48420,4,B27,2024-07-19 12:20:54,11955,6706,2338,807,21806
1826820,U48420,1,B26,2024-07-19 12:41:51,14090,6173,2462,958,23683
1826821,U48420,3,B26,2024-07-19 12:41:51,14090,6173,2463,958,23684
1826827,U48420,1,B19,2024-07-19 12:43:14,29899,18755,5356,1296,55306
1828520,U48420,1,B3,2024-07-19 13:36:32,32891,18726,5390,1861,58868
1828725,U48420,1,B21,2024-07-19 13:39:26,87247,50773,18001,3702,159723
1828775,U48420,1,B15,2024-07-19 13:40:08,64871,33599,14798,2774,116042
1829655,U48420,1,B35,2024-07-19 13:51:04,10402,7628,2338,424,20792
1829656,U48420,2,B35,2024-07-19 13:51:04,10402,7629,2338,424,20793
1841214,U48420,1,B17,2024-07-19 15:10:35,19000,13688,4605,806,38099
1841215,U48420,2,B17,2024-07-19 15:10:35,19000,13689,4605,806,38100
1845057,U48420,2,B27,2024-07-19 15:28:17,12126,6781,2351,812,22070
1845058,U48420,1,B27,2024-07-19 15:28:17,12127,6781,2351,812,22071
1848020,U48420,2,B6,2024-07-19 15:40:18,14897,7968,2256,890,26011
1848021,U48420,1,B6,2024-07-19 15:40:18,14898,7968,2256,890,26012
1848126,U48420,1,B3,2024-07-19 15:40:37,33400,18879,5422,1875,59576
1849291,U48420,1,B21,2024-07-19 15:45:12,88177,51331,18100,3722,161330
1851979,U48420,1,B15,2024-07-19 15:55:24,65558,33900,14919,2790,117167
1851980,U48420,2,B15,2024-07-19 15:55:24,65558,33901,14919,2790,117168
1851984,U48420,3,B15,2024-07-19 15:55:24,65558,33901,14920,2790,117169
1851986,U48420,4,B15,2024-07-19 15:55:24,65558,33901,14920,2791,117170
1863716,U48420,2,B19,2024-07-19 16:39:41,30387,19075,5420,1308,56190
1863718,U48420,1,B19,2024-07-19 16:39:41,30388,19075,5420,1308,56191
1864498,U22405,2,B43,2024-07-19 16:42:37,12715,9034,3156,507,25412
1864500,U22405,1,B43,2024-07-19 16:42:37,12716,9034,3156,507,25413
1864709,U22405,2,B52,2024-07-19 16:43:20,17696,12534,4460,546,35236
1864715,U22405,1,B52,2024-07-19 16:43:20,17697,12534,4460,546,35237
1864922,U22405,1,B42,2024-07-19 16:44:10,18067,11870,4874,491,35302
1864923,U22405,2,B42,2024-07-19 16:44:10,18067,11871,4874,491,35303
1865106,U22405,2,B47,2024-07-19 16:44:47,23970,17540,5814,613,47937
1865108,U22405,1,B47,2024-07-19 16:44:47,23971,17540,5814,613,47938
1865207,U22405,1,B44,2024-07-19 16:45:16,25081,15602,6135,1305,48123
1865383,U22405,2,B59,2024-07-19 16:45:51,28976,20347,7591,954,57868
1865384,U22405,1,B59,2024-07-19 16:45:51,28977,20347,7591,954,57869
1865400,U48420,1,B22,2024-07-19 16:45:54,3227,1601,601,301,5730
1865401,U48420,3,B22,2024-07-19 16:45:54,3227,1601,602,301,5731
1865779,U22405,2,B45,2024-07-19 16:47:11,24578,16934,6390,1038,48940
1865781,U22405,1,B45,2024-07-19 16:47:11,24579,16934,6390,1038,48941
1867977,U48420,1,B34,2024-07-19 16:54:47,12715,6229,2481,974,22399
1867978,U48420,2,B34,2024-07-19 16:54:47,12715,6230,2481,974,22400
1868558,U48420,2,B24,2024-07-19 16:56:58,24617,14350,4626,1237,44830
1868562,U48420,1,B24,2024-07-19 16:56:58,24618,14350,4626,1237,44831
1869540,U48420,1,B23,2024-07-19 17:00:50,29887,16909,4979,1776,53551
1869541,U48420,3,B23,2024-07-19 17:00:50,29887,16909,4980,1776,53552
1870242,U48420,2,B4,2024-07-19 17:03:33,34537,17847,6984,1972,61340
1870249,U48420,1,B4,2024-07-19 17:03:33,34539,17848,6984,1972,61343
1923172,U48420,1,B60,2024-07-19 20:43:18,47794,18496,11542,2307,80139
1923173,U48420,3,B60,2024-07-19 20:43:18,47794,18496,11543,2307,80140
1923238,U48420,1,B21,2024-07-19 20:43:42,91360,53374,18717,3845,167296
1923240,U48420,2,B21,2024-07-19 20:43:42,91360,53375,18717,3845,167297
1923439,U48420,1,B15,2024-07-19 20:45:16,67750,35005,15410,2871,121036
1923440,U48420,2,B15,2024-07-19 20:45:16,67750,35006,15410,2871,121037
1925264,U48420,2,B8,2024-07-19 20:54:58,15817,10874,2645,962,30298
1925266,U48420,1,B8,2024-07-19 20:54:58,15818,10874,2645,962,30299
1925522,U48420,1,B3,2024-07-19 20:56:07,35360,19863,5584,1944,62751
1925739,U48420,1,B6,2024-07-19 20:56:58,15920,8462,2389,959,27730
1938311,U48420,2,B13,2024-07-19 21:53:11,40579,23512,7535,2385,74011
1938312,U48420,4,B13,2024-07-19 21:53:11,40579,23512,7535,2386,74012
1938313,U48420,3,B13,2024-07-19 21:53:11,40579,23512,7536,2386,74013
1938315,U48420,1,B13,2024-07-19 21:53:11,40580,23512,7536,2386,74014
1938944,U48420,1,B72,2024-07-19 21:56:03,22564,11007,3318,1407,38296
1953216,U48420,1,B3,2024-07-19 23:05:49,36108,20234,5640,1965,63947
1953219,U48420,2,B3,2024-07-19 23:05:49,36108,20235,5640,1965,63948
1953813,U48420,1,B7,2024-07-19 23:08:52,34732,20730,6529,1985,63976
1958886,U48420,2,B72,2024-07-19 23:31:31,22807,11132,3352,1419,38710
1958887,U48420,1,B72,2024-07-19 23:31:31,22808,11132,3352,1419,38711
1958888,U48420,3,B72,2024-07-19 23:31:31,22808,11132,3353,1419,38712
1961656,U48420,1,B17,2024-07-19 23:43:42,20182,14659,4766,856,40463
1961657,U48420,3,B17,2024-07-19 23:43:42,20182,14659,4767,856,40464
1962816,U48420,1,B25,2024-07-19 23:49:26,18758,13744,3039,1054,36595
1962822,U48420,2,B25,2024-07-19 23:49:26,18758,13745,3039,1054,36596
1998128,U22405,1,B59,2024-07-20 02:15:38,31051,21940,8045,1009,62045
1998129,U22405,2,B59,2024-07-20 02:15:38,31051,21941,8045,1009,62046
1998391,U22405,3,B44,2024-07-20 02:16:40,26856,16624,6628,1406,51514
1998393,U22405,1,B44,2024-07-20 02:16:40,26857,16624,6628,1406,51515
1998510,U22405,1,B47,2024-07-20 02:17:12,25710,18751,6338,654,51453
1998518,U22405,2,B47,2024-07-20 02:17:12,25710,18752,6338,654,51454
1998669,U22405,1,B42,2024-07-20 02:17:44,19537,12818,5283,538,38176
1998907,U22405,1,B52,2024-07-20 02:18:36,19026,13480,4811,585,37902
1998909,U22405,2,B52,2024-07-20 02:18:36,19026,13481,4811,585,37903
1999192,U22405,2,B43,2024-07-20 02:19:38,13725,9727,3420,554,27426
1999193,U22405,1,B43,2024-07-20 02:19:38,13726,9727,3420,554,27427
1999457,U22405,2,B46,2024-07-20 02:20:47,8438,5945,2277,231,16891
1999459,U22405,1,B46,2024-07-20 02:20:47,8439,5945,2277,231,16892
2038921,U9,3,B7,2024-07-20 06:01:21,36225,21683,6758,2063,66729
2038922,U9,2,B7,2024-07-20 06:01:21,36225,21684,6758,2063,66730
2038923,U9,1,B7,2024-07-20 06:01:21,36226,21684,6758,2063,66731
2039187,U9,1,B13,2024-07-20 06:03:19,42702,24767,7926,2497,77892
2039306,U9,1,B12,2024-07-20 06:04:17,31548,15523,5679,1930,54680
2039401,U9,1,B72,2024-07-20 06:04:52,23596,11532,3486,1475,40089
2047898,U48420,1,B13,2024-07-20 08:08:54,42896,24856,7952,2505,78209
2047899,U48420,2,B13,2024-07-20 08:08:54,42896,24857,7952,2505,78210
2048163,U48420,3,B12,2024-07-20 08:14:19,31692,15571,5699,1941,54903
2048164,U48420,1,B12,2024-07-20 08:14:19,31693,15571,5699,1941,54904
2048469,U48420,1,B21,2024-07-20 08:20:40,97202,56941,19854,4129,178126
2048507,U48420,1,B5,2024-07-20 08:21:52,97030,64573,17736,4152,183491
2048559,U48420,1,B4,2024-07-20 08:23:15,37796,19555,7554,2099,67004
2059488,U16,1,B3,2024-07-20 14:21:55,38003,21183,5901,2053,67140
2060973,U16,1,B6,2024-07-20 14:31:33,17213,9053,2575,1024,29865
2060974,U16,2,B6,2024-07-20 14:31:33,17213,9054,2575,1024,29866
2060975,U16,4,B6,2024-07-20 14:31:33,17213,9054,2575,1025,29867
2061497,U16,1,B7,2024-07-20 14:34:41,36617,21811,6804,2077,67309
2062817,U48420,1,B5,2024-07-20 14:42:03,97739,64919,17781,4170,184609
2062819,U48420,2,B5,2024-07-20 14:42:03,97739,64920,17781,4170,184610
2063112,U48420,1,B2,2024-07-20 14:43:35,38193,20006,7441,1903,67543
2063113,U48420,2,B2,2024-07-20 14:43:35,38193,20007,7441,1903,67544
2063482,U48420,2,B3,2024-07-20 14:45:11,38104,21208,5902,2054,67268
2063486,U48420,1,B3,2024-07-20 14:45:11,38105,21208,5902,2054,67269
2063802,U48420,2,B6,2024-07-20 14:46:44,17249,9068,2576,1025,29918
2063808,U48420,1,B6,2024-07-20 14:46:44,17250,9068,2576,1025,29919
2065110,U16,3,B23,2024-07-20 14:52:12,32926,18579,5394,1928,58827
2065113,U16,1,B23,2024-07-20 14:52:12,32927,18579,5394,1928,58828
2065465,U16,1,B4,2024-07-20 14:53:38,38103,19669,7586,2111,67469
2086343,U9,1,B2,2024-07-20 15:58:11,38551,20227,7494,1910,68182
2086344,U9,2,B2,2024-07-20 15:58:11,38551,20228,7494,1910,68183
2095788,U9,1,B16,2024-07-20 16:21:10,15802,9884,2945,1116,29747
2095793,U9,2,B16,2024-07-20 16:21:10,15802,9885,2945,1116,29748
2104205,U22405,1,B52,2024-07-20 16:47:18,20249,14356,5127,616,40348
2104206,U22405,2,B52,2024-07-20 16:47:18,20249,14357,5127,616,40349
2104293,U9,1,B68,2024-07-20 16:47:33,6660,2768,1677,605,11710
2104298,U9,2,B68,2024-07-20 16:47:33,6660,2769,1677,605,11711
2104478,U22405,2,B42,2024-07-20 16:48:01,20675,13556,5570,571,40372
2104482,U22405,1,B42,2024-07-20 16:48:01,20676,13556,5570,571,40373
2104633,U22405,1,B47,2024-07-20 16:48:36,27196,19725,6820,702,54443
2104635,U22405,2,B47,2024-07-20 16:48:36,27196,19726,6820,702,54444
2104784,U22405,1,B44,2024-07-20 16:49:06,28490,17609,7026,1487,54612
2104983,U22405,2,B59,2024-07-20 16:49:48,32992,23424,8462,1048,65926
2104984,U22405,1,B59,2024-07-20 16:49:48,32993,23424,8462,1048,65927
2105262,U22405,1,B45,2024-07-20 16:50:52,28005,19268,7323,1186,55782
2105266,U22405,2,B45,2024-07-20 16:50:52,28005,19269,7323,1186,55783
2106555,U9,1,B24,2024-07-20 16:55:25,27857,16164,5262,1422,50705
2106557,U9,2,B24,2024-07-20 16:55:25,27857,16165,5262,1422,50706
2113086,U9,3,B3,2024-07-20 17:16:26,38797,21582,5999,2087,68465
2113087,U9,1,B3,2024-07-20 17:16:26,38798,21582,5999,2087,68466
2117679,U9,3,B13,2024-07-20 17:33:39,44253,25630,8211,2571,80665
2117685,U9,1,B13,2024-07-20 17:33:39,44254,25630,8211,2571,80666
2120891,U16,1,B24,2024-07-20 17:47:59,28059,16289,5323,1440,51111
2120894,U16,2,B24,2024-07-20 17:47:59,28059,16290,5323,1440,51112
2124806,U16,2,B2,2024-07-20 18:02:59,39214,20579,7679,1940,69412
2124809,U16,1,B2,2024-07-20 18:02:59,39215,20579,7679,1940,69413
2125226,U16,1,B3,2024-07-20 18:04:44,39043,21730,6044,2108,68925
2125227,U16,2,B3,2024-07-20 18:04:44,39043,21731,6044,2108,68926
2125548,U16,1,B6,2024-07-20 18:05:52,17870,9409,2668,1051,30998
2130476,U48420,1,B7,2024-07-20 18:23:13,37837,22526,7104,2144,69611
2130479,U48420,2,B7,2024-07-20 18:23:13,37837,22527,7104,2144,69612
2130751,U9,2,B12,2024-07-20 18:24:05,33071,16242,5917,2003,57233
2130754,U9,1,B12,2024-07-20 18:24:05,33072,16242,5917,2003,57234
2131142,U48420,1,B13,2024-07-20 18:25:23,44512,25784,8268,2590,81154
2133819,U48420,1,B15,2024-07-20 18:34:59,74931,38614,17186,3198,133929
2133820,U48420,2,B15,2024-07-20 18:34:59,74931,38615,17186,3198,133930
2133823,U48420,3,B15,2024-07-20 18:34:59,74931,38615,17187,3198,133931
2134670,U48420,2,B24,2024-07-20 18:38:28,28241,16395,5374,1450,51460
2134672,U48420,1,B24,2024-07-20 18:38:28,28242,16395,5374,1450,51461
2134844,U48420,1,B34,2024-07-20 18:39:07,14433,7072,2820,1103,25428
2135603,U9,1,B23,2024-07-20 18:41:54,34141,19277,5680,2031,61129
2135607,U9,2,B23,2024-07-20 18:41:54,34141,19278,5680,2031,61130
2135984,U9,2,B24,2024-07-20 18:43:14,28265,16412,5379,1452,51508
2135985,U9,1,B24,2024-07-20 18:43:14,28266,16412,5379,1452,51509
2137899,U9,1,B8,2024-07-20 18:50:40,17612,12078,2945,1065,33700
2138657,U9,1,B2,2024-07-20 18:53:26,39484,20732,7739,1947,69902
2141181,U9,2,B13,2024-07-20 19:03:30,44730,25909,8330,2612,81581
2141184,U9,1,B13,2024-07-20 19:03:30,44731,25909,8330,2612,81582
2143248,U9,1,B4,2024-07-20 19:11:39,39582,20482,7979,2231,70274
2147675,U9,1,B6,2024-07-20 19:28:58,18198,9575,2712,1068,31553
2147676,U9,2,B6,2024-07-20 19:28:58,18198,9576,2712,1068,31554
2149486,U9,1,B17,2024-07-20 19:35:52,21861,15867,5150,970,43848
2149551,U48420,1,B3,2024-07-20 19:36:10,39764,22150,6132,2141,70187
2150579,U9,1,B27,2024-07-20 19:40:10,15043,8329,2806,976,27154
2150695,U48420,1,B15,2024-07-20 19:40:37,75430,38862,17330,3229,134851
2152231,U48420,2,B17,2024-07-20 19:45:47,21882,15884,5152,972,43890
2152233,U48420,1,B17,2024-07-20 19:45:47,21883,15884,5152,972,43891
2153853,U48420,1,B35,2024-07-20 19:51:20,12329,9006,2749,513,24597
2153862,U48420,2,B35,2024-07-20 19:51:20,12329,9008,2750,513,24600
2186136,U48420,1,B3,2024-07-20 22:21:58,40816,22652,6224,2163,71855
2186595,U48420,1,B2,2024-07-20 22:23:43,40602,21422,7957,1988,71969
2186728,U48420,2,B5,2024-07-20 22:24:13,103317,68525,18936,4415,195193
2186731,U48420,1,B5,2024-07-20 22:24:13,103319,68526,18936,4415,195196
2187755,U48420,1,B4,2024-07-20 22:28:35,40470,20934,8135,2266,71805
2187764,U48420,3,B4,2024-07-20 22:28:35,40470,20934,8136,2266,71806
